"ZIP","0_25000","25000_50000","50000_75000","75000_100000","100000_200000","200000_","nbrReturns","medianInc","jl_benef"
10001,"4409","2740","1789","1161","1758","1345","13202","45000",1194
10002,"26652","8984","3867","2001","2257","957","44718","20973",3698
10003,"6876","5340","4453","3009","5216","4641","29535","64327",2402
10004,"342","301","240","209","419","591","2102","95096",123
10005,"920","879","722","500","1060","1200","5281","80950",282
10006,"385","408","291","259","491","442","2276","80212",139
10007,"608","387","297","228","654","1417","3591","142202",233
10009,"11454","7720","4917","2712","3517","1267","31587","39054",3244
10010,"3443","2946","2581","1926","3351","2861","17108","70971",1316
10011,"6855","5203","4245","3144","5851","5371","30669","69293",2603
10012,"3484","2518","1864","1237","2191","1888","13182","57900",941
10013,"7060","2444","1443","976","1652","2895","16470","37019",1070
10014,"4115","3162","2666","2090","3972","3362","19367","72571",1513
10016,"6370","5757","4963","3374","5778","4867","31109","67263",2177
10017,"5012","2100","1715","1237","2347","2518","14929","55131",708
10018,"1730","1340","707","481","840","838","5936","48097",376
10019,"6016","4748","3378","2378","4230","3544","24294","60235",2192
10021,"4686","3655","3444","2592","4551","5965","24893","81375",1597
10022,"3652","3073","2548","1951","3967","4997","20188","85520",1238
10023,"7426","4952","4383","3329","6869","7581","34540","78822",2795
10024,"7377","4988","3956","3000","5434","6754","31509","71417",2622
10025,"15332","9953","6428","3930","6771","5420","47834","46564",4380
10026,"8214","5053","2077","1011","1144","508","18007","28909",2074
10027,"13116","7169","2767","1310","1567","660","26589","25621",2802
10028,"5153","4407","3874","2656","4482","5102","25674","71147",1806
10029,"17047","9754","3432","1207","997","440","32877","24107",3621
10030,"6610","3917","1310","507","370","101","12815","24236",1614
10031,"16785","8687","2543","924","722","156","29817","22204",3362
10032,"16862","10736","2599","1030","796","146","32169","23847",3424
10033,"14756","9326","2612","1206","1268","311","29479","24973",3366
10034,"10834","6397","2204","1034","890","138","21497","24802",2537
10035,"7521","3855","1450","638","516","126","14106","23444",1682
10036,"5829","4242","2420","1586","2597","2044","18718","45804",1856
10037,"3936","2985","1639","686","495","66","9807","33107",1077
10038,"4036","2167","1447","886","1483","940","10959","41659",896
10039,"6556","3771","1401","567","417","64","12776","24359",1480
10040,"11300","7028","2258","884","849","171","22490","24878",2629
10044,"1309","935","637","460","716","270","4327","47861",385
10065,"2873","2628","2139","1567","2820","3444","15471","76532",1026
10069,"341","288","229","191","519","943","2511","139884",184
10075,"2644","2194","2033","1466","2352","2984","13673","74570",1018
10128,"7422","5690","4906","3223","5407","5988","32636","66337",2479
10162,"107","70","62","77","166","235","717","125301",52
10280,"546","462","425","434","1038","820","3725","99712",346
10282,"290","187","202","176","501","993","2349","163673",130
10301,"6154","4006","2462","1601","1913","591","16727","38792",1573
10302,"3048","1653","1060","684","745","74","7264","33832",746
10303,"4872","2865","1587","997","859","43","11223","31457",1191
10304,"7681","4358","2330","1401","1803","628","18201","33140",1825
10305,"6453","4236","2857","2057","2398","380","18381","41153",2044
10306,"8428","5336","3976","3091","4534","790","26155","46786",2913
10307,"1832","1039","879","696","1245","328","6019","53953",679
10308,"3743","2317","2003","1704","2623","403","12793","54194",1493
10309,"4082","2531","2082","1688","2887","646","13916","54143",1677
10310,"3973","2305","1424","1017","1436","253","10408","38351",1018
10312,"7833","5096","4248","3574","5684","1074","27509","54855",3199
10314,"12518","8084","5953","4613","6458","1069","38695","46122",4186
10451,"11676","6511","2087","692","352","23","21341","22846",2421
10452,"21443","12117","2348","608","257","0","36773","21436",3916
10453,"23103","12757","2240","623","249","0","38972","21086",4080
10454,"9035","3917","859","228","137","0","14176","19613",1679
10455,"9914","4775","997","291","128","0","16105","20305",2057
10456,"23837","10602","2360","597","264","0","37660","19749",4333
10457,"19198","9124","2149","548","258","0","31277","20364",3322
10458,"18907","10316","2473","844","387","0","32927","21770",3385
10459,"11976","6300","1402","445","208","0","20331","21222",2430
10460,"14028","7667","1725","586","261","0","24267","21625",2704
10461,"8484","6410","3523","2007","1767","202","22393","35577",2316
10462,"15397","11923","5768","2451","1437","95","37071","31582",3910
10463,"12562","8530","4583","2668","3153","926","32422","35695",3258
10464,"605","432","350","224","396","89","2096","50786",194
10465,"6318","5034","3285","2009","2345","312","19303","41557",2153
10466,"14474","9336","3788","1676","1217","56","30547","27142",3226
10467,"21093","13296","4588","1703","1037","43","41760","24748",4406
10468,"20242","12385","2807","999","489","34","36956","22821",3430
10469,"12997","8610","4245","2128","1907","161","30048","30886",2988
10470,"2735","2337","1119","590","570","58","7409","35366",684
10471,"2657","2142","1664","1214","1698","765","10140","54072",850
10472,"15208","8131","2322","745","451","24","26881","22094",2967
10473,"12433","8319","3489","1548","1072","52","26913","28074",3254
10474,"2802","1368","308","86","38","0","4602","20530",532
10475,"6994","6786","4233","2066","1130","40","21249","38373",1957
10533,"901","439","416","332","706","839","3633","79518",261
10543,"3017","1663","1264","836","1525","1187","9492","51305",788
10550,"7984","5738","2113","928","657","44","17464","28259",2080
10573,"7176","4423","2071","1101","1916","1316","18003","35321",1594
10603,"2768","2088","1472","1039","1500","492","9359","47893",854
10606,"3249","1864","914","525","902","466","7920","34536",615
10701,"12016","7287","3565","1849","2107","338","27162","30369",3297
10705,"7848","4869","2148","1079","1216","249","17409","29395",1924
10801,"6894","5267","2370","1365","1940","614","18450","36064",2037
10803,"1493","824","671","493","1008","1359","5848","72615",415
10921,"638","382","298","257","380","76","2031","49738",196
10977,"11110","5783","2471","1484","2141","499","23488","27741",1809
11001,"3806","2494","1926","1516","2729","731","13202","53907",1155
11003,"7974","5756","3349","2067","2226","190","21562","37192",2053
11004,"2026","1376","1096","806","1090","147","6541","47602",557
11005,"276","204","240","188","343","132","1383","72083",44
11010,"3575","2401","1861","1454","2290","341","11922","49844",1204
11021,"2409","1339","1250","920","1780","1438","9136","66400",567
11030,"1994","883","737","600","1620","2827","8661","107160",436
11040,"5674","3549","2841","2212","4466","1348","20090","57233",1493
11096,"1783","983","439","228","209","0","3642","25966",414
11101,"6034","3261","1585","776","1011","449","13116","29017",1484
11102,"8296","7163","2575","1140","1073","153","20400","31645",1893
11103,"8802","5583","2951","1363","1100","160","19959","30275",2036
11104,"6391","3746","2217","1053","1034","146","14587","31026",1590
11105,"7626","5169","3076","1473","1486","261","19091","34286",2085
11106,"9076","5758","3193","1484","1244","189","20944","31061",2194
11109,"262","260","371","278","536","269","1976","83543",133
11201,"7197","5196","4260","2958","5179","3836","28626","61268",2471
11203,"16334","11218","4599","2042","1408","89","35690","28367",3802
11204,"15954","7006","3340","1735","1736","483","30254","23704",2957
11205,"7392","4243","2198","1114","1290","366","16603","30362",1827
11206,"19222","9008","2953","957","613","116","32869","21374",3964
11207,"22462","11639","3893","1400","656","50","40100","22315",4756
11208,"23596","12190","3515","1213","607","35","41156","21802",4794
11209,"11476","7368","5436","3334","4030","1230","32874","41833",3182
11210,"12068","7734","3670","1821","1985","737","28015","31271",2744
11211,"18037","10183","4773","2319","2660","1037","39009","28602",3848
11212,"20160","11104","3306","1128","544","28","36270","22489",4390
11213,"14499","7884","2871","1108","672","106","27140","23398",3051
11214,"17905","8792","4588","2416","2226","367","36294","25688",4059
11215,"10292","7917","5559","3327","5418","3063","35576","48671",3263
11216,"12646","7600","3117","1190","794","121","25468","25289",3042
11217,"5445","4326","2963","1692","2483","1417","18326","46486",1996
11218,"14697","7233","4072","2183","2471","573","31229","28170",2816
11219,"19516","5872","2276","1146","1149","386","30345","19435",2133
11220,"32057","8509","3003","1398","1175","200","46342","18070",3457
11221,"18571","9579","3260","1211","628","61","33310","22421",4093
11222,"8416","6301","3526","1624","1506","287","21660","34578",2743
11223,"14737","7066","3564","1902","1929","734","29932","25810",3027
11224,"9845","5035","2342","1097","906","131","19356","24576",2232
11225,"13319","8866","3780","1414","986","195","28560","27710",3151
11226,"24949","14702","5097","1913","1122","215","47998","24048",5425
11228,"7342","3807","2436","1520","2060","539","17704","34916",1737
11229,"14275","7654","4585","2937","3447","800","33698","33407",3434
11230,"15195","7536","4006","2291","2392","1006","32426","28377",2809
11231,"5296","3664","2473","1583","2415","1285","16716","45892",1960
11232,"6514","3442","1166","455","356","64","11997","23020",1092
11233,"14311","8088","3245","1238","663","83","27628","24132",3433
11234,"14316","9818","6241","4035","4770","908","40088","39585",4114
11235,"16306","8448","4785","2803","3174","870","36386","30584",3297
11236,"19278","13555","6347","3131","2344","200","44855","30810",4877
11237,"12554","5764","1591","525","295","25","20754","20665",2220
11238,"9823","7607","4619","2388","2695","940","28072","38846",3017
11239,"2607","2153","1153","387","158","0","6458","32222",689
11354,"14890","5142","2588","2358","1416","256","26650","22372",1685
11355,"28493","7529","3242","1745","1516","223","42748","18754",2529
11356,"5196","2658","1373","827","794","111","10959","27671",1075
11357,"6049","3785","2864","2260","3113","754","18825","47213",1658
11358,"7261","3661","2267","1729","2133","438","17489","35127",1398
11360,"2804","1839","1560","1219","1916","551","9889","54824",791
11361,"4843","2834","1960","1408","1817","456","13318","41020",1108
11362,"2688","1660","1269","1026","1519","394","8556","48946",637
11363,"1039","557","470","378","593","333","3370","54734",228
11364,"5850","3475","2706","1890","2415","467","16803","43360",1367
11365,"7890","4367","2793","1859","2231","352","19492","35625",1974
11366,"2559","1340","862","572","993","235","6561","38451",505
11367,"7381","4703","2576","1498","1659","373","18190","34111",1549
11368,"25937","12209","3482","1204","617","45","43494","20961",3495
11369,"8435","5066","1715","841","553","44","16654","24680",1491
11370,"6211","3599","1485","790","768","107","12960","26869",1115
11372,"17036","8787","4097","1950","1767","289","33926","24893",3111
11373,"27509","11247","4335","1952","1435","131","46609","21179",3614
11374,"8306","5281","3553","2093","2141","412","21786","37247",2135
11375,"10172","7208","6012","4060","5775","1938","35165","50840",3403
11377,"22421","10540","4923","2373","2071","231","42559","23728",3763
11378,"6584","3994","2474","1468","1466","163","16149","34326",1882
11379,"5885","3812","2819","1869","2327","354","17066","42366",1914
11385,"21038","12201","6022","3007","2528","249","45045","28041",5620
11411,"3680","2907","1716","1010","903","58","10274","37530",1003
11412,"7486","5107","2679","1321","915","46","17554","31320",1815
11413,"7729","5776","3103","1750","1482","104","19944","34708",1870
11414,"4089","2891","2266","1509","1777","296","12828","45105",1508
11415,"3116","2349","1718","953","987","171","9294","41294",924
11416,"6131","3864","1182","475","351","0","12003","24474",1333
11417,"6355","3748","1763","942","877","59","13744","28449",1576
11418,"8133","4452","1902","924","853","118","16382","25326",1679
11419,"11304","5760","2259","877","607","45","20852","23058",2078
11420,"9808","6242","2722","1298","1004","67","21141","28052",2133
11421,"9211","5355","2197","1161","886","53","18863","26032",2148
11422,"5853","4312","2472","1362","1221","87","15307","35442",1576
11423,"6303","4178","1896","919","830","204","14330","30158",1440
11426,"2916","1815","1241","970","1325","142","8409","42741",717
11427,"4128","2915","1791","1016","1120","224","11194","37599",1046
11428,"3856","2660","1393","749","690","56","9404","32951",957
11429,"5163","3642","1794","876","722","38","12235","31555",1159
11430,"68","54","45","45","0","0","212","42593",20
11432,"12782","6419","2974","1578","1521","434","25708","25280",2179
11433,"7225","4047","1617","714","427","33","14063","24332",1529
11434,"12777","9182","4633","2128","1310","71","30101","31189",2971
11435,"11856","6434","3317","1486","1147","121","24361","26259",2463
11436,"3900","2542","1128","581","355","0","8506","28472",892
11507,"984","568","463","393","792","401","3601","63391",248
11516,"1023","556","404","308","590","319","3200","51300",237
11552,"3948","2517","1788","1219","2079","543","12094","45848",1170
11553,"5696","4001","1794","882","801","79","13253","30811",1405
11559,"1268","524","385","257","471","664","3569","49618",199
11563,"3279","2087","1679","1278","2211","507","11041","52293",1050
11566,"4638","2589","2115","1707","4362","2013","17424","67553",1523
11580,"6490","4467","3144","2291","3096","443","19931","44454",1859
11581,"3038","1902","1466","1162","2036","605","10209","52797",919
11590,"9027","5368","2948","1956","3083","834","23216","37020",2309
11691,"10895","6760","2349","1025","835","182","22046","25473",2163
11692,"3857","2310","906","375","292","28","7768","25292",891
11693,"2216","1410","874","537","469","37","5543","34858",717
11694,"2719","1761","1320","969","1454","444","8667","47927",873
11697,"532","318","368","298","477","139","2132","64674",161
11702,"2156","1237","1029","859","1660","589","7530","59038",692
11710,"4736","2770","2375","1890","3928","1228","16927","60084",1621
11716,"1644","1269","847","645","958","200","5563","47419",617
11717,"14479","10031","3186","1407","1050","47","30200","26548",3932
11729,"4635","3284","2194","1555","2116","222","14006","43027",1525
11731,"3945","2425","1887","1581","3437","976","14251","60016",1331
11735,"5137","3298","2524","1796","3095","573","16423","48310",1685
11746,"10929","6275","3707","2702","5265","2897","31775","44757",3148
11747,"2666","1564","1270","966","2171","1486","10123","66378",784
11749,"624","398","262","183","251","32","1750","40766",204
11756,"6686","4370","3384","2641","4312","486","21879","49336",2214
11779,"5769","4058","2863","2310","3296","350","18646","46895",2241
11791,"3076","1488","1306","1088","2666","2133","11757","75184",806
11796,"502","293","232","208","450","71","1756","58944",175
11803,"3566","1955","1681","1372","3531","1657","13762","70226",1217
12046,"111","87","67","31","50","0","346","42816",36
12204,"1381","1152","546","268","280","148","3775","36003",306
12701,"2254","1188","456","281","258","41","4478","24834",514
14009,"1019","755","394","211","202","0","2581","33974",474
14221,"8348","4774","3885","3173","4586","1674","26440","50631",1833
