"ZIP","0_25000","25000_50000","50000_75000","75000_100000","100000_200000","200000_","nbrReturns","medianInc","jl_benef"
"00000","3617400","2070870","1248170","805170","1171760","484040","9397410","38054",516980
"10001","3880","2530","1850","1300","2350","2170","14080","58514",600
"10002","23350","8270","4500","2510","3200","1540","43370","23217",1600
"10003","5380","4240","4410","3350","6280","6150","29810","81530",1040
"10004","330","300","270","210","560","870","2540","128571",70
"10005","720","810","880","590","1270","1620","5890","97669",150
"10006","290","380","360","270","600","550","2450","93056",60
"10007","460","280","230","200","590","1590","3350","185593",110
"10009","10330","7210","5690","3540","4630","1910","33310","46931",1510
"10010","2820","2490","2630","2020","3810","3780","17550","85334",590
"10011","5360","3920","3920","3120","6810","7140","30270","90505",1180
"10012","2580","1970","1800","1380","2620","2460","12810","75996",400
"10013","4750","2150","1520","1030","1960","3620","15030","60115",410
"10014","3080","2360","2520","2080","4420","4580","19040","93750",670
"10016","5250","4900","5220","3850","6820","5980","32020","79156",960
"10017","1870","1500","1560","1310","2660","3160","12060","95992",340
"10018","1470","1060","780","590","1160","1200","6260","69231",220
"10019","5160","3590","3310","2570","5110","4750","24490","76800",1090
"10021","3740","2820","3320","2470","4930","6810","24090","96913",690
"10022","2860","2310","2430","2010","4440","6080","20130","110248",530
"10023","6070","3900","3860","3290","7190","9410","33720","98024",1360
"10024","6060","3850","3700","2930","5970","8400","30910","90742",1110
"10025","13550","8390","6250","4080","7450","7090","46810","55860",2140
"10026","7590","4250","2450","1320","1690","850","18150","33735",1110
"10027","12410","6630","3350","1650","2190","1140","27370","29808",1520
"10028","4320","3340","3800","2830","5160","6300","25750","87500",780
"10029","17280","9060","4290","1710","1570","790","34700","25193",1950
"10030","7070","3570","1660","670","580","150","13700","24222",950
"10031","15360","7780","3480","1470","1230","310","29630","24113",1780
"10032","16220","7650","3430","1390","1190","280","30160","23243",1880
"10033","13870","6300","3060","1520","1710","540","27000","24333",1730
"10034","10150","4810","2630","1270","1260","250","20370","25182",1330
"10035","7610","3790","1690","850","890","280","15110","24819",860
"10036","4670","3140","2540","1950","3370","2630","18300","63189",990
"10037","4660","2840","1800","950","810","100","11160","33099",700
"10038","3630","2040","1720","1150","2170","1660","12370","57485",430
"10039","7150","3460","1670","710","590","120","13700","23951",890
"10040","10520","5220","2740","1240","1210","310","21240","25479",1440
"10044","1210","780","630","440","820","400","4280","55952",150
"10065","2470","2120","2170","1650","3170","4310","15890","92955",450
"10069","330","230","220","170","520","1200","2670","174038",90
"10075","2320","1800","2030","1580","3000","3590","14320","90981",410
"10128","6190","4940","5030","3500","6250","7350","33260","78357",1170
"10162","100","50","60","60","190","280","740","152632",0
"10280","510","440","430","420","1190","1190","4180","124370",160
"10282","230","140","120","120","380","1250","2240","NA",60
"10301","6660","3820","2540","1660","2320","770","17770","39562",910
"10302","3440","1780","1020","670","930","110","7950","32514",400
"10303","5360","2810","1560","980","1110","80","11900","30249",660
"10304","8180","4220","2300","1530","2100","800","19130","33205",970
"10305","6700","3930","2890","2010","2830","530","18890","42462",1070
"10306","8300","4990","3850","3030","4980","1130","26280","49248",1560
"10307","1840","990","810","740","1360","480","6220","58642",380
"10308","3850","2350","1980","1650","2990","600","13420","56439",790
"10309","4160","2570","2020","1660","3330","970","14710","57735",910
"10310","4340","2330","1390","1060","1710","360","11190","38466",560
"10312","8120","5030","4080","3540","6530","1490","28790","57629",1700
"10314","12710","7890","5810","4690","7420","1600","40120","48289",2160
"10451","12720","6260","2430","920","550","40","22920","22524",1450
"10452","22500","9160","3060","830","420","30","36000","20000",2220
"10453","24210","9060","2690","830","430","20","37240","19228",2430
"10454","10240","3840","1090","330","200","0","15700","19165",970
"10455","10840","4670","1450","410","220","0","17590","20284",1140
"10456","26050","9960","2860","840","410","20","40140","19261",2540
"10457","20930","7840","2370","770","350","20","32280","19279",1910
"10458","20690","8450","2920","1070","580","30","33740","20384",1970
"10459","12670","5590","1760","630","320","0","20970","20689",1390
"10460","15190","6170","2040","740","450","0","24590","20235",1590
"10461","8800","6080","3970","2210","2300","290","23650","37438",1290
"10462","16430","10890","6430","2870","2060","140","38820","31841",2130
"10463","12830","7450","4930","3030","3950","1300","33490","38138",1860
"10464","540","400","380","240","420","140","2120","57895",130
"10465","6410","4400","3220","2180","2880","430","19520","44034",1260
"10466","15260","9170","4080","1930","1690","100","32230","27331",1860
"10467","23150","11960","5360","2060","1430","90","44050","23785",2470
"10468","21500","8760","3310","1250","740","50","35610","20703",2020
"10469","13770","8280","4550","2450","2390","270","31710","31295",1730
"10470","2940","1860","1140","640","740","100","7420","35349",400
"10471","2420","1640","1560","1280","1950","970","9820","63622",370
"10472","16520","7260","2660","950","620","30","28040","21217",1640
"10473","13080","7530","3690","1800","1400","90","27590","27374",1830
"10474","2980","1300","390","110","60","0","4840","20302",330
"10475","7350","6440","4530","2300","1540","70","22230","39616",980
"10501","190","80","70","60","150","130","680","75000",20
"10502","730","280","270","270","610","700","2860","88889",100
"10504","1040","380","300","280","890","2510","5400","178652",120
"10505","180","80","60","30","100","110","560","58333",20
"10506","770","240","210","150","440","990","2800","106818",80
"10507","900","470","320","240","400","350","2680","48404",100
"10509","3160","1730","1250","1020","2020","780","9960","51800",460
"10510","1150","490","420","300","1000","1520","4880","108000",190
"10511","350","220","160","130","220","60","1140","50000",70
"10512","3480","2190","1720","1350","2800","790","12330","57195",690
"10514","1360","400","280","240","840","2330","5450","152976",120
"10516","720","460","340","310","610","270","2710","62868",120
"10518","200","90","60","50","150","170","720","80000",0
"10520","1590","930","780","590","1330","1050","6270","69712",280
"10522","1250","810","680","530","1070","880","5220","70221",210
"10523","1590","970","700","480","820","210","4770","45490",250
"10524","500","320","240","240","490","280","2070","72396",110
"10526","290","120","120","80","190","190","990","67708",30
"10527","100","50","50","40","110","100","450","90625",0
"10528","1560","920","760","550","950","1060","5800","63816",240
"10530","1430","1010","1080","900","1740","950","7110","75972",290
"10532","660","400","340","290","680","270","2640","69118",120
"10533","870","420","380","340","760","1020","3790","91544",130
"10535","120","100","50","40","70","0","380","42500",30
"10536","1350","570","440","360","1020","1440","5180","90972",170
"10537","400","270","160","130","220","30","1210","43981",90
"10538","1760","760","720","550","1300","2880","7970","115000",250
"10541","3610","2020","1620","1340","2980","990","12560","60031",690
"10543","2920","1550","1140","880","1620","1490","9600","57237",420
"10546","160","70","60","60","160","200","710","103125",30
"10547","1110","690","490","370","760","220","3640","51020",170
"10548","450","280","210","190","360","100","1590","57738",70
"10549","2810","1410","820","590","1180","1410","8220","48050",290
"10550","9000","5380","2360","1100","880","60","18780","26812",1310
"10552","3030","2320","1790","1250","1710","590","10690","49946",640
"10553","2240","1510","840","460","580","80","5710","35182",340
"10560","540","310","210","190","460","430","2140","76316",90
"10562","5390","3190","2080","1420","2590","1180","15850","44867",690
"10566","4650","2830","1690","1090","1510","300","12070","37235",650
"10567","2520","1460","1110","930","2280","1160","9460","66892",440
"10570","1540","740","620","470","1190","1410","5970","79521",210
"10573","7240","4180","2140","1290","2100","1700","18650","37470",960
"10576","640","230","200","130","500","790","2490","109000",70
"10577","430","140","130","90","190","590","1570","98611",50
"10578","110","70","60","50","110","40","440","66667",20
"10579","1080","750","590","520","1020","420","4380","65254",220
"10580","1960","790","650","470","1180","2930","7980","110169",220
"10583","4410","1720","1660","1310","3340","6440","18880","110180",490
"10588","340","230","190","130","290","90","1270","58553",50
"10589","910","580","610","580","1180","670","4530","82112",150
"10590","800","340","330","270","740","690","3170","85648",130
"10591","3810","2280","1430","1020","1860","1440","11840","48136",650
"10594","690","390","290","250","560","350","2530","65948",110
"10595","820","450","420","320","750","470","3230","70536",160
"10597","130","60","20","30","70","190","500","114286",0
"10598","3730","2090","1670","1360","3760","1800","14410","70734",660
"10601","1830","1190","820","590","940","650","6020","49790",210
"10603","3010","2000","1460","1070","1730","660","9930","49438",480
"10604","1850","1090","760","460","830","630","5620","47018",300
"10605","2680","1500","1180","910","2080","1820","10170","69174",330
"10606","3350","1860","1020","580","1000","630","8440","36694",330
"10607","1170","780","520","370","770","420","4030","53125",160
"10701","13100","7020","3640","1970","2470","460","28660","29380",1800
"10703","3890","2530","1500","1010","1300","190","10420","38043",580
"10704","4960","3750","2870","1980","2520","440","16520","47000",880
"10705","8420","4520","2280","1270","1400","360","18250","28899",1140
"10706","1050","570","480","420","940","1050","4510","84226",150
"10707","1290","730","670","530","1110","720","5050","68843",240
"10708","2360","1450","1550","1290","2320","2330","11300","80620",390
"10709","1210","720","550","440","1050","800","4770","70682",180
"10710","3690","2700","2220","1770","2840","720","13940","56532",700
"10801","7260","4000","2470","1550","2240","840","18360","37000",1320
"10803","1460","780","620","450","1030","1630","5970","81944",200
"10804","1600","690","640","530","1480","2170","7110","106419",220
"10805","2940","2080","1550","1050","1200","330","9150","44651",570
"10901","3430","1880","1420","1100","2390","1320","11540","58099",530
"10913","710","350","250","240","620","380","2550","71500",110
"10916","650","330","240","230","510","190","2150","59896",120
"10917","290","170","140","90","210","100","1000","57143",40
"10918","1690","950","760","580","1200","350","5530","54112",310
"10919","180","130","80","70","110","30","600","48077",40
"10920","1260","720","540","490","1090","370","4470","61806",230
"10921","670","390","310","250","460","100","2180","52419",130
"10923","1610","1060","700","500","760","150","4780","43396",270
"10924","1840","1070","750","630","1310","480","6080","54333",250
"10925","760","480","380","300","480","70","2470","49740",210
"10926","580","370","300","240","330","100","1920","50833",90
"10927","3230","1540","590","320","380","90","6150","23800",570
"10928","840","590","350","230","260","50","2320","38559",140
"10930","1300","600","490","450","1120","400","4360","64286",220
"10931","170","120","70","70","70","0","500","41667",40
"10940","9250","5560","3250","2140","2870","390","23460","36151",1270
"10941","2280","1680","1020","710","1050","150","6890","42336",400
"10950","6850","2800","1820","1520","3240","960","17190","40580",720
"10952","5600","2190","1210","750","1570","1010","12330","31450",330
"10954","3770","2210","1590","1320","2620","860","12370","53223",640
"10956","4370","2140","1690","1410","4010","2340","15960","71746",720
"10958","530","300","220","180","320","70","1620","48333",90
"10960","2430","1460","1050","720","1330","730","7720","49486",400
"10962","740","400","330","240","570","320","2600","62121",130
"10963","400","240","190","140","230","20","1220","46875",70
"10964","200","100","70","70","130","160","730","73214",30
"10965","2020","1150","980","800","1950","760","7660","66837",370
"10968","270","160","170","150","310","190","1250","79167",40
"10969","210","110","90","70","100","30","610","46591",40
"10970","1530","950","760","560","980","350","5130","52796",310
"10973","340","200","130","130","220","60","1080","50000",50
"10974","490","290","210","150","330","90","1560","50000",80
"10975","40","40","30","20","20","0","150","46875",0
"10976","360","140","100","60","140","60","860","37500",30
"10977","12330","5870","2510","1540","2280","700","25230","26214",1010
"10980","2100","1300","910","690","1510","480","6990","52610",460
"10983","780","430","330","300","800","330","2970","70833",150
"10984","340","220","170","150","350","80","1310","63971",70
"10985","40","40","50","0","40","0","170","52500",0
"10986","260","160","120","80","210","90","920","58333",60
"10987","640","270","190","160","390","260","1910","55921",100
"10989","1230","810","680","600","1180","410","4910","65257",260
"10990","2900","1600","1170","1030","2140","820","9660","57051",450
"10992","1460","820","580","510","1130","240","4740","53879",250
"10993","1130","610","350","210","250","20","2570","31352",190
"10994","1050","530","440","330","920","550","3820","68750",150
"10996","410","160","160","230","240","50","1250","58594",0
"10998","460","280","200","190","360","60","1550","54375",80
"11001","3910","2360","1820","1430","3050","1090","13660","57692",640
"11003","8640","6000","3530","2340","2760","330","23600","38167",1230
"11004","1980","1310","1070","810","1230","210","6610","50350",260
"11005","220","160","200","210","420","220","1430","91071",0
"11010","3520","2290","1880","1460","2700","540","12390","55120",630
"11020","880","450","270","210","540","700","3050","68056",70
"11021","2250","1310","1140","950","1900","1830","9380","74781",260
"11023","1030","520","390","310","790","870","3910","76210",70
"11024","960","430","310","240","490","760","3190","66532",50
"11030","1910","830","750","520","1390","3170","8570","119784",200
"11040","5790","3390","2670","2220","5030","1960","21060","62640",780
"11050","4150","2120","1470","1180","2700","3230","14850","69643",600
"11096","1910","940","440","250","240","20","3800","24869",220
"11101","5840","3330","2210","1310","2070","1050","15810","40503",860
"11102","7670","4770","3130","1700","1810","360","19440","35744",1020
"11103","7640","5570","3680","1870","1850","310","20920","37657",1070
"11104","5840","3540","2520","1420","1610","340","15270","37677",800
"11105","6840","4840","3450","1890","2230","470","19720","40599",1110
"11106","8300","5530","3790","2020","2190","360","22190","37636",1190
"11109","360","360","500","490","1190","860","3760","114286",130
"11201","6460","4000","4040","3140","6420","6030","30090","79339",1310
"11203","17020","10780","5040","2420","1840","150","37250","28722",2230
"11204","16890","7290","3530","1940","2290","680","32620","24142",1450
"11205","7530","4290","2450","1420","1960","770","18420","34790",970
"11206","18790","9760","4280","1720","1270","250","36070","23995",2140
"11207","23520","11010","4440","1880","1170","70","42090","22369",2720
"11208","24890","11440","4160","1680","1030","60","43260","21726",2650
"11209","11430","6890","5420","3710","5110","1650","34210","45591",1520
"11210","12370","7690","3900","2120","2440","1030","29550","32819",1660
"11211","11260","7120","4840","2760","3530","1440","30950","39800",1450
"11212","21280","10380","3850","1450","780","30","37770","22186",2590
"11213","14560","8080","3570","1530","1080","220","29040","24931",1790
"11214","19290","9190","4700","2820","2900","540","39440","26170",1900
"11215","7020","5970","5410","3770","6600","4900","33670","67768",1620
"11216","11710","8230","4440","1950","1640","360","28330","32457",1680
"11217","4560","3470","3000","1940","3110","2290","18370","59625",920
"11218","14800","7060","4260","2630","3350","1080","33180","31339",1430
"11219","21160","6630","2590","1260","1530","550","33720","19920",1010
"11220","37080","9460","3350","1590","1550","340","53370","17992",1470
"11221","18860","10790","4560","1810","1290","190","37500","24854",2240
"11222","6620","5540","4340","2420","2710","790","22420","45713",1490
"11223","15650","7220","3550","2070","2460","1010","31960","26143",1510
"11224","10020","4730","2200","1280","1180","230","19640","24501",1130
"11225","13400","8680","4500","1980","1550","370","30480","30300",1840
"11226","25840","14810","6280","2620","1910","380","51840","25135",3320
"11228","7960","3850","2360","1670","2400","740","18980","34935",910
"11229","14740","7880","4510","3020","4170","1170","35490","34534",1670
"11230","15420","7960","4350","2390","3060","1400","34580","30873",1470
"11231","4660","3030","2200","1620","3070","2230","16810","58125",970
"11232","6790","3110","1520","690","650","130","12890","23730",520
"11233","14970","8740","3830","1700","1220","180","30640","26001",1980
"11234","14710","9630","6130","4250","5590","1320","41630","40849",2320
"11235","16760","7990","4710","3050","3840","1200","37550","31305",1630
"11236","20490","12980","6780","3610","3190","300","47350","31134",3020
"11237","11920","7060","2680","970","730","100","23460","24602",1250
"11238","8410","6980","5390","2920","4180","1870","29750","48155",1650
"11239","2820","2080","1170","510","240","0","6820","32091",390
"11354","17410","5400","2740","1550","1810","400","29310","21044",910
"11355","33920","8040","3320","1840","1810","360","49290","18164",1120
"11356","5700","2780","1420","830","1010","150","11890","27203",610
"11357","6170","3550","2780","2190","3700","1140","19530","50405",890
"11358","7770","3670","2290","1560","2430","660","18380","34673",670
"11360","2710","1580","1460","1230","2210","810","10000","62158",380
"11361","4910","2770","1870","1400","2100","660","13710","42554",560
"11362","2590","1560","1230","1040","1720","540","8680","53862",330
"11363","940","570","430","340","650","450","3380","60465",100
"11364","5830","3370","2600","1880","2830","770","17280","45846",660
"11365","8370","4330","2770","1920","2670","540","20600","36143",1090
"11366","2460","1280","840","640","1040","380","6640","41797",240
"11367","7630","4020","2610","1590","1970","550","18370","34670",770
"11368","29250","11800","4410","1670","1010","80","48220","20607",1850
"11369","9210","4430","2050","980","820","80","17570","23846",840
"11370","6320","3040","1680","940","1060","160","13200","27303",540
"11372","17340","8130","4520","2310","2450","520","35270","25907",1510
"11373","28720","11780","5320","2400","2080","250","50550","22001",1720
"11374","8140","4890","3740","2380","2840","650","22640","41258",1020
"11375","9270","6200","5760","4330","6930","2870","35360","59592",1540
"11377","22160","10830","5790","3000","2910","420","45110","25912",1940
"11378","6830","3900","2540","1660","2000","320","17250","36506",1040
"11379","5650","3570","2790","1940","2930","590","17470","46604",980
"11385","21250","12490","6950","3550","3740","400","48380","30885",2880
"11411","3810","2730","1720","1110","1120","100","10590","38599",570
"11412","7810","5240","2770","1580","1240","90","18730","32419",1050
"11413","8290","5640","3270","2030","1890","180","21300","35461",1110
"11414","3870","2720","2150","1600","2190","450","12980","49081",780
"11415","3040","2140","1750","1060","1290","280","9560","45327",460
"11416","6140","3170","1410","620","460","40","11840","24104",710
"11417","6570","3660","1910","1090","1130","100","14460","29508",930
"11418","8320","4400","2210","1070","1200","180","17380","27102",930
"11419","12050","6010","2500","1150","890","80","22680","23527",1050
"11420","10090","6050","3040","1550","1410","130","22270","29318",1130
"11421","9510","5130","2570","1330","1250","110","19900","27144",1190
"11422","6100","4280","2530","1550","1490","140","16090","36361",870
"11423","6510","4020","2070","1100","1090","260","15050","31312",780
"11426","3200","1830","1280","990","1530","240","9070","43238",360
"11427","4170","2770","1740","1100","1420","310","11510","39305",510
"11428","4050","2540","1450","870","920","80","9910","33907",530
"11429","5520","3650","1900","1030","900","60","13060","31918",690
"11430","60","40","40","30","0","0","170","40625",0
"11432","13960","6510","3300","1710","1880","570","27930","25019",1160
"11433","8240","4220","1810","920","670","50","15910","24135",890
"11434","13060","9050","5020","2560","1870","120","31680","32680",1690
"11435","12270","6470","3630","1820","1670","180","26040","27898",1300
"11436","4150","2590","1330","650","490","20","9230","29488",470
"11501","2930","2060","1630","1250","2170","550","10590","54678",480
"11507","950","550","430","410","840","590","3770","72384",110
"11509","330","170","130","130","280","250","1290","77885",50
"11510","5570","3310","2430","2000","3620","900","17830","50360",910
"11514","680","470","360","310","540","150","2510","57292",140
"11516","970","560","420","320","640","420","3330","58036",120
"11518","1520","920","810","620","1160","480","5510","59722",270
"11520","10110","5480","3010","1910","2470","460","23440","32345",1460
"11530","3400","1560","1340","1190","3120","3730","14340","93277",440
"11542","4900","2820","1710","1140","1970","850","13390","40913",730
"11545","1640","720","600","460","1140","1580","6140","80978",180
"11548","200","110","80","60","120","90","660","56250",20
"11550","14440","7290","3190","1660","1780","290","28650","24801",1770
"11552","4030","2580","1740","1280","2360","740","12730","47626",580
"11553","6410","3990","1860","980","990","80","14310","29668",860
"11554","5620","3570","2760","2140","4290","1180","19560","55344",940
"11557","1080","570","420","380","810","780","4040","72024",140
"11558","1300","800","600","370","790","200","4060","47812",240
"11559","1270","580","400","260","480","820","3810","53438",110
"11560","1020","480","380","260","570","670","3380","62500",110
"11561","5220","3210","2850","2190","3910","1610","18990","59342",1060
"11563","3260","1980","1670","1350","2570","750","11580","58234",580
"11565","1130","690","600","500","1300","500","4720","72500",210
"11566","4790","2490","2140","1760","4540","2610","18330","72021",850
"11568","410","210","120","90","200","620","1650","98611",30
"11570","3860","2050","1590","1260","2820","2640","14220","68868",570
"11572","4420","2500","2050","1620","3750","1450","15790","61890",780
"11575","4210","2300","1150","610","540","40","8850","27337",550
"11576","1530","630","500","450","1120","2060","6290","103125",130
"11577","1560","780","610","550","1140","1290","5930","75682",210
"11579","710","370","300","260","550","450","2640","70000",110
"11580","6910","4590","3360","2360","3810","650","21680","46405",1130
"11581","3110","1870","1430","1200","2370","710","10690","56381",480
"11590","9700","5570","3080","1990","3680","1230","25250","38128",1350
"11596","1380","790","640","550","1320","720","5400","70703",210
"11598","1620","710","560","480","1210","1360","5940","79167",180
"11691","11290","5670","2500","1180","1120","270","22030","24391",1310
"11692","4070","2230","960","480","460","60","8260","25673",510
"11693","2290","1250","780","530","600","60","5510","34300",370
"11694","2610","1580","1150","880","1590","590","8400","50217",470
"11697","500","270","270","240","490","180","1950","68981",90
"11701","5770","3600","1950","1160","1600","410","14490","35243",840
"11702","2060","1220","980","830","1780","800","7670","64158",400
"11703","2780","1910","1500","1040","1720","250","9200","48822",550
"11704","6800","4720","3220","2210","3360","460","20770","43988",1310
"11705","1110","540","460","440","990","470","4010","69293",170
"11706","12530","8390","4150","2710","3540","810","32130","35533",2200
"11709","1000","520","450","380","780","370","3500","62778",170
"11710","5130","2870","2290","1820","4240","1670","18020","61026",870
"11713","1860","1210","730","510","750","210","5270","41012",340
"11714","3610","2360","1800","1330","2650","640","12390","53125",650
"11715","610","340","300","260","620","210","2340","68333",100
"11716","1620","1080","820","630","1150","290","5590","52896",310
"11717","16010","9720","3760","1610","1340","90","32530","25656",2350
"11718","420","220","180","160","420","310","1710","80469",70
"11719","400","300","230","200","350","130","1610","61413",70
"11720","4700","2780","2020","1610","2940","590","14640","48561",890
"11721","820","420","350","310","780","620","3300","79839",140
"11722","8820","5290","2340","1350","1340","120","19260","28828",1290
"11724","420","190","150","100","280","540","1680","95000",40
"11725","4020","2200","1700","1500","3620","1620","14660","66324",740
"11726","4810","2830","1370","820","900","150","10880","30565",690
"11727","4400","3210","2340","1700","2530","330","14510","47235",980
"11729","4890","3300","2180","1540","2510","360","14780","43939",880
"11730","2160","1200","950","730","1670","580","7290","57500",410
"11731","4370","2360","1840","1540","3630","1420","15160","61549",740
"11732","460","280","230","170","430","300","1870","71196",70
"11733","2200","1090","850","780","2120","1640","8680","81410",290
"11735","5200","3390","2400","1910","3500","830","17230","50260",900
"11738","2660","1650","1140","890","1650","260","8250","47197",560
"11740","1320","640","510","430","1020","600","4520","64706",190
"11741","3910","2700","2110","1600","3260","660","14240","56043",920
"11742","1940","1230","1020","790","1470","300","6750","55025",430
"11743","6010","3230","2530","1950","4620","3740","22080","67787",910
"11746","11680","5980","3800","2760","5670","3630","33520","46237",1700
"11747","2630","1450","1120","980","2380","2030","10590","77423",410
"11749","590","430","270","190","270","50","1800","43023",130
"11751","2310","1430","1060","800","1610","490","7700","52594",510
"11752","1610","1100","740","560","1060","170","5240","47955",350
"11753","1630","750","600","440","1400","1680","6500","90341",220
"11754","2690","1560","1180","1000","2310","770","9510","60699",460
"11755","1790","1030","870","730","1370","420","6210","58190",360
"11756","6750","4420","3340","2640","4950","780","22880","52021",1240
"11757","7990","4900","3480","2590","4020","520","23500","44184",1680
"11758","8030","4760","3800","2980","6640","2570","28780","60526",1450
"11762","3020","1680","1400","1190","3190","1120","11600","69643",610
"11763","4910","3080","2010","1580","2430","420","14430","43709",1000
"11764","1750","890","680","590","1720","680","6310","68934",330
"11765","60","50","30","30","50","100","320","91667",0
"11766","1680","860","670","620","1610","740","6180","70522",260
"11767","2010","1120","890","690","1790","700","7200","63202",370
"11768","2840","1380","1210","1030","2530","2040","11030","77063",430
"11769","1370","830","680","550","1260","350","5040","61765",250
"11771","1440","780","620","410","840","1010","5100","63306",160
"11772","7970","5150","3190","2270","3410","560","22550","41044",1410
"11776","4060","2340","1600","1280","2340","490","12110","46314",740
"11777","1250","690","520","480","1070","660","4670","68990",160
"11778","1820","1130","860","730","1290","240","6070","52471",410
"11779","5870","3990","2880","2260","3780","550","19330","48778",1220
"11780","2220","1130","880","660","1660","1190","7740","64773",290
"11782","2140","1260","1000","860","1980","770","8010","65125",350
"11783","2960","1680","1440","1190","2930","910","11110","65885",540
"11784","4060","2690","1850","1340","2130","220","12290","44377",870
"11786","850","400","310","300","840","390","3090","73790",160
"11787","4590","2400","1960","1770","4430","1930","17080","69770",780
"11788","2270","1360","1120","920","2090","790","8550","64397",410
"11789","1030","720","580","440","770","110","3650","53233",220
"11790","1840","960","690","620","1720","910","6740","70652",280
"11791","3080","1370","1210","960","2720","2700","12040","84375",390
"11792","1310","640","450","460","1110","430","4400","63889",210
"11793","4410","2440","2010","1780","4420","1590","16650","68346",850
"11795","3640","2190","1560","1370","3080","1140","12980","60577",690
"11796","510","310","240","200","480","130","1870","61979",100
"11797","1240","540","460","330","770","1300","4640","81061",110
"11798","3770","2330","980","470","630","100","8280","28970",540
"11801","7110","4430","3070","2340","3940","760","21650","45965",1110
"11803","3580","1840","1590","1320","3710","2260","14300","77652",580
"11804","630","310","310","240","640","420","2550","77604",100
"11901","5370","3240","1620","950","1310","280","12770","32832",720
"11933","1130","700","450","400","630","150","3460","46429",180
"11934","1170","690","460","420","910","270","3920","55435",230
"11935","560","310","260","200","360","180","1870","56250",100
"11937","3190","1820","1090","710","1180","880","8870","42102",510
"11939","160","100","70","70","90","50","540","53571",30
"11940","870","470","340","290","570","230","2770","53309",150
"11941","380","210","170","130","320","100","1310","59559",90
"11942","850","470","320","240","510","230","2620","49468",110
"11944","910","530","270","210","300","140","2360","37736",130
"11946","3030","1590","990","660","1060","350","7680","37736",480
"11948","190","120","80","50","140","50","630","51562",30
"11949","2170","1200","880","700","1600","520","7070","54688",420
"11950","3120","1850","1070","730","900","70","7740","35135",660
"11951","2430","1480","930","620","690","50","6200","36318",590
"11952","800","460","340","260","500","200","2560","51471",120
"11953","2010","1450","1090","790","1070","150","6560","46897",400
"11954","1050","670","350","210","300","180","2760","37313",400
"11955","500","380","290","200","260","60","1690","47697",120
"11957","120","80","60","50","90","60","460","62500",20
"11958","170","100","60","50","70","40","490","43750",20
"11961","2220","1450","1050","750","1160","160","6790","45259",370
"11963","1280","810","530","380","640","510","4150","49537",150
"11967","4520","2920","1880","1230","1830","160","12540","39983",1080
"11968","1840","1020","670","410","780","620","5340","45343",250
"11971","910","560","420","330","610","250","3080","54167",140
"11976","320","210","130","80","180","230","1150","58654",40
"11977","460","200","140","120","260","160","1340","51786",60
"11978","800","380","240","140","300","210","2070","40461",90
"11980","590","440","380","300","470","80","2260","56579",150
"12007","30","20","20","30","0","0","100","50000",0
"12008","60","40","30","30","70","0","230","62500",0
"12009","1100","680","560","450","770","210","3770","54688",160
"12010","5430","3420","1810","1120","1180","170","13130","33297",980
"12015","510","350","260","190","290","60","1660","47857",90
"12017","50","50","20","20","40","0","180","45000",0
"12018","1080","790","610","470","780","160","3890","53074",230
"12019","1890","1320","1100","1050","1920","460","7740","65000",310
"12020","4960","3450","2370","1850","2880","520","16030","47138",820
"12022","140","90","80","40","50","0","400","41667",50
"12023","330","210","180","120","170","0","1010","45833",60
"12025","970","670","400","320","340","50","2750","40112",230
"12027","530","350","270","250","510","120","2030","62500",70
"12028","210","150","110","70","80","0","620","41667",50
"12029","150","90","80","70","70","40","500","53125",0
"12031","40","30","30","0","0","0","100","33333",0
"12032","160","140","70","50","60","0","480","39286",30
"12033","1190","830","640","470","820","150","4100","51172",200
"12035","150","120","70","40","30","0","410","36458",40
"12037","650","430","270","170","190","60","1770","38663",90
"12041","80","60","40","30","50","0","260","45833",0
"12042","60","60","40","40","30","0","230","47917",0
"12043","1260","720","450","320","340","50","3140","35764",280
"12046","90","70","70","40","60","0","330","51786",0
"12047","3590","2850","1540","950","1130","230","10290","38640",620
"12051","620","420","290","170","220","40","1760","40476",100
"12052","210","160","130","100","140","0","740","50000",50
"12053","610","430","330","290","450","60","2170","53409",130
"12054","2120","1380","1240","1080","2190","810","8820","68347",220
"12056","350","230","200","150","240","40","1210","53125",70
"12057","280","200","140","70","90","0","780","38750",50
"12058","230","160","120","70","90","0","670","41406",50
"12059","230","190","130","100","160","0","810","48026",60
"12060","190","140","100","80","100","40","650","49107",30
"12061","1320","1030","760","610","1020","290","5030","55428",190
"12062","230","220","160","100","130","0","840","46591",70
"12063","80","60","40","30","70","0","280","50000",0
"12064","80","60","30","30","0","0","200","33333",30
"12065","6010","4290","3340","2520","4960","1290","22410","56774",940
"12066","280","250","160","140","140","0","970","45500",90
"12067","240","150","140","90","140","20","780","50000",40
"12068","460","420","230","130","130","0","1370","38393",100
"12070","210","170","90","70","80","20","640","41176",50
"12071","50","30","50","0","0","0","130","37500",20
"12072","400","330","190","130","150","0","1200","40152",120
"12074","450","370","220","190","250","30","1510","45608",100
"12075","510","310","220","150","230","60","1480","43548",70
"12076","220","130","100","60","60","0","570","37500",60
"12077","900","520","400","350","780","280","3230","62188",90
"12078","4370","2710","1310","730","660","100","9880","30258",790
"12083","640","430","330","200","280","20","1900","43023",120
"12084","550","540","480","350","380","80","2380","55208",80
"12085","70","80","30","30","0","0","210","35938",0
"12086","280","240","160","120","140","0","940","44792",70
"12087","190","140","100","60","110","0","600","44643",50
"12090","990","660","440","270","260","30","2650","37689",170
"12092","200","130","90","50","60","0","530","37500",40
"12093","270","160","110","50","70","0","660","34375",60
"12094","320","270","180","130","170","0","1070","44907",80
"12095","2150","1590","830","520","490","50","5630","35456",440
"12106","390","250","220","140","240","70","1310","51705",50
"12108","70","70","30","20","30","0","220","39286",0
"12110","2940","2240","1720","1250","1860","360","10370","50073",400
"12116","330","220","120","60","70","0","800","32955",60
"12117","570","470","220","130","160","0","1550","35904",150
"12118","2300","1710","1160","760","1340","240","7510","46272",420
"12120","80","50","50","30","40","0","250","47500",20
"12121","300","180","150","140","160","30","960","50000",60
"12122","700","470","320","170","190","0","1850","36968",170
"12123","770","610","430","290","400","70","2570","46107",160
"12125","270","180","110","60","60","30","710","36806",60
"12130","170","130","90","70","60","0","520","42308",30
"12131","40","40","0","30","0","0","110","34375",0
"12134","630","440","270","170","180","30","1720","38068",140
"12136","130","90","50","40","80","40","430","48611",0
"12137","270","220","150","110","140","0","890","44886",60
"12138","450","360","230","160","150","20","1370","41319",120
"12139","60","0","40","0","30","0","130","53125",0
"12140","250","210","130","110","170","30","900","48810",40
"12143","810","610","390","290","350","0","2450","42008",130
"12144","3300","2730","1710","1180","1390","190","10500","42857",580
"12147","70","70","40","50","60","0","290","53125",0
"12148","610","300","290","270","670","240","2380","74138",80
"12149","400","250","130","80","120","0","980","34000",100
"12150","150","100","90","50","70","0","460","45000",30
"12151","100","120","90","50","80","0","440","50000",20
"12153","120","100","80","80","90","0","470","54688",20
"12154","450","340","240","190","240","30","1490","46691",110
"12155","290","200","110","70","60","0","730","34375",60
"12156","120","90","80","60","80","0","430","51562",20
"12157","650","430","300","210","230","30","1850","40988",150
"12158","870","650","520","390","590","110","3130","52163",170
"12159","1140","610","510","410","1000","710","4380","71569",100
"12160","140","100","70","50","50","0","410","41250",40
"12164","120","70","40","30","30","0","290","33929",0
"12165","50","40","30","20","30","30","200","58333",0
"12166","230","190","100","60","60","0","640","36842",60
"12167","460","300","160","90","110","0","1120","33333",90
"12168","320","230","130","90","140","0","910","39674",70
"12169","60","30","20","20","30","0","160","41667",0
"12170","860","580","360","300","360","60","2520","42241",150
"12173","260","180","140","90","110","0","780","43056",50
"12175","110","80","60","40","40","0","330","42188",30
"12176","40","20","20","30","0","0","110","43750",0
"12180","9180","6120","3290","1930","2430","410","23360","35212",1410
"12182","2780","1940","1000","610","680","60","7070","34729",500
"12183","520","520","220","100","80","0","1440","34615",110
"12184","1020","660","490","350","580","140","3240","47727",170
"12185","320","210","160","90","150","30","960","44048",70
"12186","840","600","490","420","770","240","3360","62245",130
"12187","160","120","50","40","50","0","420","35417",40
"12188","1820","1440","950","680","950","150","5990","45399",310
"12189","3310","2720","1400","710","880","150","9170","36719",550
"12190","110","90","70","30","40","0","340","41667",20
"12192","280","160","110","90","90","0","730","38281",40
"12193","300","260","180","120","170","0","1030","45673",70
"12194","40","20","20","30","0","0","110","43750",0
"12196","450","300","220","190","340","80","1580","54545",80
"12197","350","250","150","90","100","0","940","37000",90
"12198","1160","860","670","440","770","160","4060","50373",200
"12202","2420","1270","360","130","90","0","4270","22056",310
"12203","4190","3340","2350","1470","1910","460","13720","44985",460
"12204","1210","1210","570","300","360","180","3830","39566",160
"12205","4630","3910","2710","1650","1860","180","14940","43159",600
"12206","4050","1930","600","300","270","40","7190","22191",420
"12207","430","180","50","20","40","0","720","20930",50
"12208","3420","2640","1540","980","1290","280","10150","40672",400
"12209","2040","1570","810","420","400","40","5280","34554",250
"12210","2360","1490","620","230","220","60","4980","27181",290
"12211","1580","940","830","660","1300","750","6060","65361",170
"12302","4110","3010","2260","1850","2630","360","14220","49917",610
"12303","5540","3410","2150","1420","2130","430","15080","39663",730
"12304","4420","2820","1430","750","790","70","10280","31383",610
"12305","930","570","220","80","90","0","1890","25658",110
"12306","4570","3500","2120","1380","1780","210","13560","40786",750
"12307","2000","670","130","50","0","0","2850","17812",170
"12308","2840","1800","770","420","430","70","6330","29514",370
"12309","3830","2440","2130","1820","3650","1220","15090","64965",480
"12401","6920","3910","2230","1350","1570","320","16300","32864",910
"12404","600","350","240","160","200","60","1610","39643",120
"12405","140","80","50","30","40","0","340","34375",20
"12406","160","70","50","0","30","0","310","24219",30
"12407","40","30","40","0","0","0","110","37500",0
"12409","170","90","60","40","60","40","460","41667",0
"12410","60","40","40","0","30","0","170","40625",0
"12411","80","50","50","30","30","0","240","45000",0
"12412","140","70","50","40","50","0","350","37500",0
"12413","600","360","190","110","130","0","1390","31597",100
"12414","1860","1120","690","400","460","80","4610","34933",270
"12416","50","30","30","0","0","0","110","29167",0
"12418","90","50","40","30","30","0","240","40000",20
"12419","120","60","40","40","80","0","340","45833",20
"12421","50","40","40","0","20","0","150","40625",0
"12422","40","40","30","30","0","0","140","43750",0
"12423","210","120","60","40","50","0","480","31250",40
"12424","40","40","0","20","0","0","100","31250",0
"12427","110","40","30","20","0","0","200","22727",0
"12428","1200","620","340","190","210","30","2590","28831",240
"12430","190","120","50","40","50","0","450","32292",30
"12431","250","170","110","80","90","0","700","39706",70
"12433","80","40","30","30","50","0","230","46875",0
"12434","170","90","50","40","0","0","350","26389",30
"12435","70","40","30","30","20","0","190","40625",20
"12439","80","60","0","40","0","0","180","29167",0
"12440","350","220","150","100","140","30","990","41477",50
"12442","200","110","60","40","40","20","470","32955",40
"12443","590","390","300","260","410","90","2040","53333",120
"12444","50","30","40","0","30","0","150","45833",0
"12446","840","460","360","230","270","30","2190","38859",210
"12448","40","40","0","20","0","0","100","31250",0
"12449","650","410","250","160","170","20","1660","35976",90
"12451","320","210","120","90","100","0","840","36905",60
"12454","50","40","0","20","0","0","110","28125",0
"12455","300","190","110","60","70","0","730","33553",40
"12456","140","110","80","30","20","0","380","36364",40
"12457","120","60","50","20","40","0","290","35417",0
"12458","420","260","190","80","110","0","1060","35577",80
"12460","50","30","30","30","0","0","140","41667",0
"12461","290","180","110","70","110","20","780","38889",50
"12463","240","160","120","90","100","0","710","42969",50
"12464","200","100","70","30","50","0","450","31250",0
"12466","490","390","250","170","220","30","1550","43269",80
"12468","210","120","70","40","40","0","480","31250",60
"12469","110","60","60","30","40","0","300","41667",20
"12470","90","60","40","0","30","0","220","33333",0
"12472","310","220","130","80","100","0","840","37500",50
"12473","180","90","60","50","60","0","440","36111",30
"12474","230","130","80","50","80","0","570","35577",40
"12477","3310","2100","1260","860","1090","190","8810","38036",560
"12480","100","60","50","0","30","0","240","33333",30
"12481","250","160","100","50","100","20","680","39062",40
"12482","160","100","50","30","20","0","360","30000",20
"12484","450","290","210","170","250","70","1440","48276",70
"12485","210","130","70","30","50","0","490","31731",40
"12486","220","150","120","90","150","0","730","49167",40
"12487","500","310","210","180","180","40","1420","41935",60
"12491","380","210","150","90","150","40","1020","40476",60
"12492","40","40","0","30","0","0","110","34375",0
"12494","120","80","60","40","60","0","360","43750",0
"12495","50","30","40","0","40","0","160","50000",0
"12496","300","130","80","70","80","20","680","32692",50
"12498","870","430","300","250","390","180","2420","44767",80
"12501","370","250","160","100","130","30","1040","40000",50
"12502","150","120","80","60","60","30","500","45833",30
"12503","110","60","30","30","60","0","290","39583",0
"12507","40","40","0","20","0","0","100","31250",0
"12508","2970","2030","1340","920","1240","170","8670","41810",500
"12513","170","140","100","70","90","30","600","48214",20
"12514","400","200","190","160","300","90","1340","59211",60
"12515","290","190","110","80","130","0","800","39474",50
"12516","260","190","110","70","80","30","740","39474",40
"12517","80","60","40","0","30","0","210","35417",0
"12518","880","520","400","300","610","220","2930","54062",160
"12520","430","300","230","170","390","150","1670","61413",80
"12521","260","180","120","70","100","30","760","41667",40
"12522","810","570","340","210","260","40","2230","38377",140
"12523","300","230","130","100","110","0","870","39674",60
"12524","2070","1450","1240","990","1660","370","7780","57460",380
"12525","590","360","300","180","280","90","1800","46528",120
"12526","660","450","240","190","250","70","1860","40000",90
"12528","2100","1400","990","770","1060","200","6520","45714",380
"12529","420","260","150","100","150","60","1140","39423",60
"12531","420","300","210","160","360","100","1550","56548",90
"12533","3440","1890","1510","1350","2990","1110","12290","63493",640
"12534","3280","2020","1010","600","630","170","7710","32116",380
"12538","2180","1440","1000","710","1090","170","6590","44358",330
"12540","1150","570","420","380","850","380","3750","59226",160
"12542","930","640","430","320","500","110","2930","45898",230
"12543","510","390","240","170","170","0","1480","39744",100
"12545","720","440","300","230","330","190","2210","46875",100
"12546","540","350","200","120","150","50","1410","36786",70
"12547","450","310","240","160","230","50","1440","46774",110
"12548","260","140","140","80","140","0","760","46429",70
"12549","1540","930","690","560","1050","210","4980","50725",320
"12550","10770","5840","2900","2100","2850","600","25060","32534",1530
"12553","3990","2720","1870","1340","2050","400","12370","45175",730
"12561","2490","1370","980","750","1260","360","7210","45347",350
"12563","1200","600","450","390","670","220","3530","48542",190
"12564","960","670","420","370","730","240","3390","53869",140
"12565","350","210","120","60","60","0","800","30952",40
"12566","1640","1050","730","570","870","110","4970","45119",370
"12567","450","320","190","130","150","50","1290","40234",60
"12569","1600","1050","720","560","910","260","5100","47619",270
"12570","950","510","400","390","910","250","3410","65312",180
"12571","1460","920","620","470","790","260","4520","46739",190
"12572","1290","830","610","460","830","380","4400","53279",140
"12575","330","180","140","130","280","80","1140","60714",80
"12577","300","150","120","110","230","60","970","57292",50
"12578","360","220","130","130","230","70","1140","48864",80
"12580","570","380","270","220","350","90","1880","49342",80
"12581","280","210","170","100","150","60","970","49405",60
"12582","630","370","300","280","590","150","2320","63333",140
"12583","400","240","140","100","160","30","1070","39062",50
"12585","150","80","50","60","90","20","450","48438",20
"12586","2090","1340","870","650","1030","140","6120","43097",420
"12589","2410","1320","920","710","1110","190","6660","42424",440
"12590","5470","3550","2720","2180","3400","650","17970","49754",980
"12592","190","170","80","70","70","0","580","39706",30
"12594","710","450","290","210","310","40","2010","41389",110
"12601","7750","4370","2200","1290","1690","300","17600","31007",900
"12603","6530","4170","3030","2310","3960","920","20920","48561",1070
"12701","2180","1150","470","290","250","60","4400","25435",270
"12719","160","80","70","40","70","0","420","40625",40
"12720","40","40","0","30","0","0","110","34375",0
"12721","1010","640","420","340","460","70","2940","42969",220
"12723","270","150","100","60","110","0","690","37500",60
"12725","40","40","40","0","20","0","140","43750",0
"12726","180","110","70","70","80","0","510","42045",40
"12729","350","230","110","60","100","0","850","33152",60
"12732","140","70","50","40","70","0","370","41071",30
"12733","110","90","20","30","0","0","250","29167",0
"12734","220","170","80","40","40","0","550","33088",30
"12737","280","170","120","100","130","0","800","42647",50
"12738","50","50","0","20","0","0","120","30000",0
"12740","310","190","180","110","140","0","930","45395",50
"12741","70","30","30","30","0","0","160","33333",0
"12742","70","40","30","20","0","0","160","31250",0
"12743","40","30","30","30","0","0","130","45833",0
"12745","50","30","0","30","0","0","110","29167",0
"12746","210","130","100","60","60","0","560","38462",40
"12747","330","200","90","70","90","0","780","32500",30
"12748","360","200","140","80","120","20","920","37500",60
"12751","210","110","70","0","30","0","420","25000",20
"12752","40","30","30","0","20","0","120","41667",0
"12754","1190","790","340","210","220","50","2800","31646",140
"12758","700","400","230","150","180","30","1690","34062",130
"12759","410","160","70","40","40","0","720","21951",60
"12760","100","50","30","30","0","0","210","27500",0
"12762","90","60","50","0","30","0","230","35417",0
"12763","130","90","60","30","40","0","350","37500",0
"12764","290","150","110","80","90","0","720","36667",50
"12765","150","110","50","50","80","0","440","40909",20
"12766","70","50","0","30","0","0","150","27500",0
"12768","140","100","60","50","50","0","400","40000",30
"12770","50","20","40","0","0","0","110","31250",0
"12771","2600","1390","780","560","750","80","6160","33633",410
"12775","370","240","200","140","230","70","1250","51875",50
"12776","320","200","130","80","110","0","840","37500",60
"12777","100","60","50","40","80","0","330","52500",0
"12779","460","290","120","50","80","0","1000","28448",40
"12780","400","250","160","120","170","0","1100","40000",60
"12783","250","150","80","50","60","0","590","32500",30
"12786","130","80","40","30","50","0","330","35938",0
"12787","70","60","50","20","30","0","230","43750",0
"12788","360","240","130","90","120","0","940","36458",50
"12789","290","190","100","50","80","0","710","33553",40
"12790","790","550","350","240","230","30","2190","38864",160
"12791","120","70","40","50","50","0","330","41071",20
"12792","80","50","30","20","20","0","200","35000",0
"12801","3350","2010","1000","590","580","90","7620","30721",530
"12803","1680","1070","630","460","400","30","4270","35631",310
"12804","4860","2790","1880","1390","2090","520","13530","42070",770
"12808","50","30","50","0","40","0","170","52500",0
"12809","580","430","260","180","190","0","1640","38953",150
"12810","130","90","50","0","20","0","290","29167",40
"12814","390","180","100","80","110","40","900","33333",110
"12815","160","140","80","50","70","0","500","41071",40
"12816","750","530","330","220","220","30","2080","38679",130
"12817","390","260","170","120","140","20","1100","40385",110
"12819","60","50","0","20","0","0","130","27500",0
"12821","50","40","30","30","0","0","150","40625",0
"12822","1070","750","450","270","240","0","2780","35667",240
"12823","40","40","40","0","20","0","140","43750",0
"12824","150","70","50","40","60","20","390","41071",40
"12827","710","490","320","200","190","20","1930","38010",190
"12828","1860","1240","700","430","470","30","4730","35181",360
"12831","2650","1630","1180","930","1670","320","8380","48620",460
"12832","1160","710","390","260","220","20","2760","32746",250
"12833","760","490","300","250","330","110","2240","43367",120
"12834","1150","730","470","350","430","70","3200","40411",210
"12835","480","300","210","130","130","0","1250","37083",90
"12836","110","70","30","20","50","0","280","35714",20
"12837","140","100","50","40","20","0","350","33750",30
"12838","120","90","50","40","40","0","340","38889",30
"12839","2680","1790","930","540","420","30","6390","32193",500
"12842","230","160","90","60","70","0","610","36719",80
"12843","110","60","60","0","40","0","270","35417",30
"12844","40","20","30","0","50","0","140","58333",0
"12845","1090","530","310","230","340","110","2610","35142",210
"12846","650","390","250","140","140","20","1590","34295",140
"12847","130","80","60","30","40","0","340","37500",40
"12849","120","70","40","40","40","0","310","37500",0
"12850","410","320","210","150","220","40","1350","45703",90
"12851","70","60","0","20","0","0","150","27083",30
"12852","70","50","40","20","30","0","210","42500",30
"12853","280","180","80","50","60","0","650","31250",70
"12855","50","30","20","20","0","0","120","33333",0
"12857","100","70","40","30","30","0","270","37500",0
"12859","340","250","170","130","150","0","1040","43000",80
"12860","150","110","40","30","20","0","350","30682",30
"12861","110","70","40","30","50","0","300","39286",30
"12863","110","90","50","50","60","0","360","44444",30
"12865","620","450","240","150","140","30","1630","35833",130
"12866","5660","3950","2660","2020","3370","1570","19230","50047",770
"12870","310","230","110","70","80","0","800","34783",40
"12871","700","460","300","240","240","30","1970","40489",100
"12873","130","80","70","40","50","0","370","42188",0
"12878","140","70","50","50","0","0","310","30357",20
"12883","960","540","330","200","230","30","2290","33565",220
"12885","990","560","310","170","170","0","2200","29911",260
"12886","50","30","40","0","0","0","120","33333",0
"12887","840","580","370","200","160","0","2150","35129",220
"12901","5790","3690","1890","1190","1350","290","14200","33875",920
"12903","200","200","170","110","110","0","790","49375",30
"12910","280","210","110","80","60","0","740","35714",80
"12912","370","290","140","90","80","0","970","34914",110
"12913","200","140","80","70","50","0","540","37500",40
"12914","130","90","50","30","20","0","320","33333",30
"12916","390","230","150","90","50","0","910","32065",100
"12917","250","140","100","70","50","0","610","34821",40
"12918","410","310","170","140","160","0","1190","39919",70
"12919","580","400","230","150","170","0","1530","36562",120
"12920","350","260","180","110","130","0","1030","40865",70
"12921","490","300","160","120","160","30","1260","36667",100
"12923","90","60","40","20","20","0","230","35417",0
"12926","350","270","130","70","70","0","890","33796",90
"12928","320","250","130","90","100","0","890","37500",100
"12930","120","70","40","40","0","0","270","30357",0
"12932","260","170","90","60","80","0","660","35294",40
"12934","160","110","70","40","30","0","410","35227",30
"12935","240","200","100","70","70","0","680","37500",40
"12936","130","70","50","30","50","0","330","37500",0
"12937","270","140","90","40","60","0","600","30357",40
"12941","240","170","100","60","70","0","640","36765",60
"12942","130","70","40","40","50","0","330","37500",0
"12943","90","40","30","20","40","0","220","37500",0
"12944","700","510","250","170","160","0","1790","34559",190
"12945","110","80","60","30","40","0","320","40625",20
"12946","1110","700","440","200","260","130","2840","36071",140
"12950","130","90","50","30","30","0","330","34722",40
"12952","100","80","40","20","20","0","260","34375",30
"12953","2080","1140","700","400","410","70","4800","32018",350
"12955","60","40","30","30","0","0","160","37500",0
"12956","190","140","90","50","30","0","500","35714",70
"12957","340","210","100","50","40","0","740","28571",80
"12958","290","240","130","110","70","0","840","38542",90
"12959","230","160","90","50","70","0","600","35938",50
"12960","150","140","80","40","60","0","470","40179",60
"12961","40","50","0","30","0","0","120","35000",20
"12962","850","610","410","290","430","50","2640","44262",180
"12965","100","60","30","40","0","0","230","31250",30
"12966","500","320","180","130","80","0","1210","33203",110
"12967","190","110","70","50","30","0","450","32955",50
"12969","60","50","20","40","0","0","170","37500",0
"12970","60","40","30","20","0","0","150","34375",0
"12972","990","680","480","340","490","60","3040","44485",220
"12974","250","180","110","60","40","0","640","34722",80
"12978","80","50","30","30","0","0","190","32500",20
"12979","460","270","210","120","160","0","1220","38889",80
"12980","240","150","90","40","40","0","560","31667",90
"12981","360","270","200","120","140","0","1090","42130",110
"12983","1400","870","530","310","400","80","3590","36351",180
"12985","180","130","70","40","40","0","460","34615",50
"12986","880","750","500","250","240","30","2650","39833",160
"12987","60","30","30","0","20","0","140","33333",0
"12989","160","110","80","50","60","0","460","40909",30
"12992","810","640","350","260","230","0","2290","38086",190
"12993","260","190","120","60","110","0","740","39474",40
"12996","370","250","140","90","80","0","930","34500",90
"12997","220","140","90","50","70","0","570","36607",50
"12998","100","60","20","40","0","0","220","29167",30
"13021","7670","4370","2700","1690","1880","330","18640","34439",1290
"13026","200","160","110","80","90","20","660","45312",40
"13027","5060","3410","2450","1810","2940","700","16370","47911",830
"13028","220","130","100","60","60","0","570","37500",60
"13029","1170","690","500","410","600","110","3480","45652",230
"13030","710","530","340","190","210","30","2010","38915",130
"13031","2620","1810","1320","880","1430","310","8370","46616",350
"13032","2340","1450","930","540","580","70","5910","35603",530
"13033","590","430","290","180","200","0","1690","39826",130
"13034","310","220","130","100","130","0","890","40341",70
"13035","1200","640","540","400","690","350","3820","53241",170
"13036","1570","1070","620","440","440","50","4190","37266",310
"13037","1480","1040","610","410","660","100","4300","41106",270
"13039","2710","1650","1290","1050","1730","310","8740","50194",440
"13040","420","330","180","100","90","0","1120","35606",190
"13041","1670","1190","890","760","950","110","5570","48424",300
"13042","390","260","160","120","100","0","1030","37019",90
"13044","430","310","210","120","130","20","1220","39516",110
"13045","4650","2910","1640","1000","1120","200","11520","34536",780
"13052","310","240","130","90","80","0","850","36979",70
"13053","750","500","330","200","320","50","2150","41250",90
"13054","280","190","110","80","60","0","720","35526",60
"13057","2810","2100","1250","740","890","140","7930","38750",460
"13060","530","360","200","130","170","30","1420","37500",90
"13061","160","110","90","60","80","0","500","45455",40
"13063","310","190","120","110","180","30","940","46053",50
"13066","1790","1000","800","690","1350","860","6490","64219",220
"13068","880","620","440","240","300","50","2530","40524",130
"13069","4470","2770","1480","890","940","90","10640","32671",1030
"13071","170","120","80","50","50","0","470","38542",30
"13072","150","120","40","30","20","0","360","31250",40
"13073","1100","770","490","300","340","40","3040","38636",200
"13074","770","510","270","160","160","0","1870","33088",190
"13076","400","270","160","130","130","0","1090","38426",80
"13077","1170","840","500","320","340","60","3230","38244",240
"13078","1220","770","540","450","910","620","4510","62269",210
"13080","590","430","270","180","220","0","1690","39826",130
"13081","140","120","80","60","90","0","490","46875",20
"13082","830","580","330","250","270","20","2280","38362",170
"13083","290","190","120","90","90","0","780","38158",80
"13084","740","490","340","250","330","70","2220","43878",140
"13088","4040","3390","2050","1170","1210","150","12010","39491",600
"13090","5020","3580","2430","1730","2540","360","15660","44623",790
"13092","400","300","170","130","120","0","1120","38333",110
"13101","480","330","190","110","80","0","1190","33712",160
"13103","90","40","30","0","0","0","160","22222",0
"13104","2330","1170","820","700","1630","1110","7760","61585",270
"13108","1000","600","460","370","590","120","3140","48750",170
"13110","350","280","190","140","160","40","1160","45536",60
"13111","300","190","130","70","40","0","730","33553",80
"13112","300","210","140","80","150","20","900","42857",60
"13114","1090","700","440","280","370","30","2910","38036",270
"13116","600","420","290","230","240","20","1800","42857",100
"13118","850","640","370","250","230","30","2370","38086",210
"13120","410","290","180","90","60","0","1030","34052",80
"13122","180","130","90","50","80","0","530","41346",30
"13126","5710","3270","2050","1370","1890","280","14570","37041",1260
"13131","600","440","260","190","180","0","1670","38352",170
"13132","690","470","260","200","240","30","1890","38564",160
"13135","1190","720","460","290","360","60","3080","37153",230
"13136","80","60","20","20","0","0","180","29167",20
"13140","820","520","300","180","150","0","1970","32933",170
"13141","140","90","50","30","20","0","330","31944",30
"13142","1100","690","400","260","310","40","2800","35870",200
"13143","460","290","190","120","100","0","1160","35345",110
"13144","240","130","90","50","30","0","540","30769",60
"13145","350","220","120","70","100","0","860","34091",90
"13146","320","240","170","80","70","0","880","37500",60
"13147","190","170","70","50","50","0","530","36029",30
"13148","2040","1190","680","480","520","70","4980","34454",320
"13152","1190","630","540","400","750","470","3980","57870",150
"13155","120","80","30","30","20","0","280","31250",30
"13156","270","200","130","80","110","0","790","40625",80
"13158","270","180","90","60","50","0","650","32639",70
"13159","800","540","340","280","440","120","2520","46296",150
"13160","330","210","160","100","110","20","930","41071",50
"13164","400","250","160","150","260","30","1250","47500",80
"13165","2110","1300","790","440","380","30","5050","32981",350
"13166","980","700","440","260","260","20","2660","37500",220
"13167","570","410","250","160","190","20","1600","39024",130
"13202","1030","370","190","70","100","40","1800","21845",90
"13203","3460","1750","580","240","300","110","6440","23266",370
"13204","4590","2200","700","250","200","50","7990","21759",530
"13205","4010","1960","770","310","260","0","7310","22787",460
"13206","3700","2680","1120","530","400","30","8460","29944",520
"13207","2730","1670","790","430","360","70","6050","29416",400
"13208","5330","2570","900","410","250","0","9460","22186",610
"13209","2700","1900","1020","600","560","60","6840","34474",450
"13210","3230","1390","670","370","460","90","6210","24033",260
"13211","1440","1050","500","180","110","0","3280","29762",220
"13212","3750","2910","1720","1080","970","100","10530","38015",580
"13214","1280","730","580","420","670","140","3820","46575",170
"13215","2260","1190","930","760","1560","470","7170","53629",300
"13219","2700","1940","1410","920","1140","130","8240","43299",390
"13224","1660","860","520","350","570","220","4180","37500",190
"13302","320","160","90","50","30","0","650","25781",70
"13303","180","130","80","70","80","0","540","42308",40
"13304","280","190","120","90","170","40","890","46711",40
"13308","610","410","250","120","130","0","1520","34146",140
"13309","1030","720","410","270","200","20","2650","35243",270
"13310","110","80","50","30","20","0","290","35938",30
"13314","90","60","30","30","0","0","210","31250",0
"13315","260","150","80","60","60","0","610","32500",60
"13316","1080","830","450","240","240","30","2870","35693",250
"13317","600","460","280","130","170","0","1640","36957",150
"13318","220","190","90","60","60","0","620","36842",50
"13319","190","120","70","40","30","0","450","32292",40
"13320","340","240","160","60","90","0","890","35938",80
"13322","200","130","100","50","60","0","540","38462",40
"13323","1530","970","710","500","730","230","4670","45747",190
"13324","340","250","150","90","70","0","900","36000",110
"13325","200","120","60","20","40","0","440","29167",50
"13326","900","540","390","240","330","210","2610","43750",130
"13327","340","270","180","110","50","0","950","37500",130
"13328","190","140","90","50","80","0","550","40179",40
"13329","650","440","270","140","100","0","1600","33523",170
"13331","50","40","30","0","20","0","140","37500",0
"13332","470","320","160","100","90","0","1140","32812",90
"13334","220","160","90","40","50","0","560","34375",50
"13335","280","190","100","70","70","0","710","34868",50
"13337","150","80","60","40","60","30","420","43750",20
"13338","240","150","110","50","50","0","600","35000",60
"13339","1160","750","370","180","180","0","2640","30333",260
"13340","1360","1020","530","360","340","40","3650","36397",280
"13343","280","210","130","70","80","0","770","37500",100
"13346","580","400","280","200","350","110","1920","48750",100
"13348","250","160","110","40","70","0","630","35156",30
"13350","1770","1050","520","320","310","30","4000","30476",320
"13354","580","350","280","170","220","20","1620","41429",80
"13355","170","100","70","30","40","0","410","33750",30
"13357","1850","1340","730","410","350","30","4710","34422",400
"13360","100","50","30","20","20","0","220","30000",20
"13361","120","70","50","50","0","0","290","33929",30
"13363","410","280","170","110","140","0","1110","37946",70
"13365","1490","940","530","320","330","40","3650","33910",300
"13367","1390","920","560","370","340","50","3630","36549",360
"13368","250","140","80","30","50","0","550","29464",60
"13402","290","180","90","50","60","0","670","31250",90
"13403","720","470","360","280","380","60","2270","47074",130
"13406","110","80","50","30","20","0","290","35938",40
"13407","960","660","400","230","190","0","2440","34848",220
"13408","420","310","150","110","140","0","1130","36694",100
"13409","410","310","170","110","90","0","1090","35887",90
"13411","570","390","180","100","100","0","1340","31410",120
"13413","2380","1550","1180","850","1320","560","7840","49839",300
"13416","330","260","160","90","120","0","960","39423",110
"13417","670","540","240","150","120","0","1720","33796",100
"13420","310","180","120","70","90","30","800","37500",90
"13421","2690","1600","880","510","590","110","6380","32812",430
"13424","360","280","190","100","170","0","1100","41964",50
"13425","340","250","150","60","80","0","880","35000",100
"13428","250","190","100","50","60","0","650","34868",50
"13431","300","210","140","100","140","0","890","42262",80
"13433","310","190","100","50","30","0","680","28947",90
"13437","70","60","40","30","0","0","200","37500",20
"13438","540","450","280","170","200","20","1660","41111",120
"13439","700","490","240","150","130","20","1730","33418",170
"13440","7170","4750","2650","1670","1690","200","18130","34974",1070
"13450","60","30","40","0","0","0","130","29167",0
"13452","790","550","300","160","140","0","1940","33182",230
"13454","130","100","60","30","20","0","340","35000",60
"13456","690","470","290","220","290","50","2010","41755",110
"13459","360","260","170","80","80","0","950","36058",120
"13460","870","560","310","180","180","0","2100","33036",130
"13461","550","360","270","210","210","30","1630","43403",60
"13464","250","150","60","30","20","0","510","25833",30
"13468","90","60","40","20","30","0","240","37500",30
"13469","130","90","60","50","60","0","390","43056",20
"13470","100","90","50","40","0","0","280","36111",30
"13471","600","400","190","120","80","0","1390","30938",150
"13473","120","100","60","40","30","0","350","38750",40
"13476","660","430","240","150","160","20","1660","34884",110
"13477","260","140","110","50","60","0","620","33929",50
"13478","480","380","250","170","150","0","1430","40461",90
"13480","580","440","220","160","170","0","1570","36648",140
"13483","50","40","30","0","0","0","120","31250",0
"13485","180","130","60","40","30","0","440","32692",50
"13486","130","100","70","40","50","0","390","41250",0
"13488","50","40","40","0","0","0","130","34375",0
"13489","100","80","60","30","20","0","290","39062",30
"13490","230","180","110","80","80","0","680","40278",40
"13491","610","450","290","150","140","20","1660","37222",170
"13492","2100","1340","900","670","900","150","6060","42351",260
"13493","340","250","130","70","40","0","830","32500",100
"13494","70","30","30","20","0","0","150","29167",0
"13495","400","350","170","90","70","0","1080","35000",50
"13501","7990","3780","1380","740","860","180","14930","23357",1000
"13502","6480","3720","1860","1010","900","100","14070","28730",890
"13601","7360","4460","2290","1230","1290","280","16910","31138",1010
"13603","1340","1660","470","150","80","0","3700","32681",110
"13605","760","480","300","200","230","30","2000","37500",150
"13606","450","310","200","130","160","0","1250","39113",90
"13607","460","220","130","100","90","30","1030","31250",180
"13608","250","160","110","60","50","0","630","35156",110
"13612","450","330","200","130","150","0","1260","38636",90
"13613","420","230","150","120","90","0","1010","34239",90
"13614","60","30","30","0","0","0","120","25000",0
"13616","320","290","120","40","30","0","800","31897",50
"13617","1340","890","630","410","500","80","3850","41433",240
"13618","310","190","140","100","120","0","860","40789",60
"13619","1740","1220","690","350","360","50","4410","34529",320
"13620","330","240","150","80","70","0","870","35938",90
"13621","100","70","50","30","20","0","270","37500",30
"13622","420","240","160","100","120","0","1040","35417",80
"13624","880","510","320","240","260","50","2260","37255",290
"13625","310","210","150","100","120","0","890","41071",90
"13626","340","280","160","100","100","0","980","38393",100
"13630","200","150","90","40","40","0","520","35000",40
"13634","700","450","290","200","210","30","1880","38333",170
"13635","170","100","60","30","30","0","390","31250",40
"13636","60","60","0","20","0","0","140","29167",0
"13637","870","820","330","120","120","0","2260","32927",120
"13638","70","70","40","0","0","0","180","32143",0
"13640","70","30","30","30","50","0","210","54167",0
"13642","1470","880","530","290","270","20","3460","32386",540
"13646","400","220","120","90","80","0","910","31250",130
"13648","320","270","170","110","80","0","950","39352",130
"13650","240","150","80","50","70","0","590","34167",40
"13652","330","190","110","60","40","0","730","29605",90
"13654","300","230","140","90","80","0","840","38043",50
"13655","720","410","160","60","70","0","1420","24653",140
"13656","480","270","190","110","90","0","1140","33333",180
"13658","380","310","180","90","100","0","1060","37097",90
"13659","100","60","50","30","20","0","260","37500",30
"13660","310","210","130","90","80","0","820","36905",90
"13661","230","170","120","70","80","0","670","40441",50
"13662","3000","1660","1010","630","650","110","7060","32982",450
"13664","70","60","40","40","40","0","250","47917",0
"13665","160","120","60","40","20","0","400","33333",60
"13667","560","340","180","130","110","0","1320","32353",120
"13668","570","370","250","150","140","0","1480","36486",130
"13669","2570","1610","930","580","640","80","6410","34860",380
"13670","80","30","40","0","0","0","150","23438",30
"13672","130","90","50","40","20","0","330","34722",20
"13673","390","300","170","90","90","0","1040","35833",110
"13676","1940","1070","740","470","620","120","4960","37617",380
"13679","360","200","110","80","90","0","840","32500",150
"13680","160","130","60","40","40","0","430","35577",50
"13681","140","90","60","50","0","0","340","33333",60
"13682","130","100","70","50","60","0","410","43750",30
"13684","170","160","70","40","40","0","480","35938",50
"13685","340","300","210","130","160","30","1170","45417",70
"13687","100","60","30","20","30","0","240","33333",30
"13690","130","80","60","30","30","0","330","35938",40
"13691","560","330","210","130","120","0","1350","33712",180
"13693","80","70","40","40","40","0","270","44643",20
"13694","220","170","120","100","110","0","720","45588",60
"13696","50","40","0","20","0","0","110","28125",0
"13697","390","270","130","90","80","0","960","33333",90
"13730","490","340","180","140","100","0","1250","34926",110
"13731","190","120","60","50","70","0","490","36458",30
"13732","1310","760","580","460","650","120","3880","45724",240
"13733","880","550","380","220","240","0","2270","36591",160
"13734","400","240","170","90","70","0","970","33854",80
"13736","390","270","170","90","120","0","1040","37037",90
"13739","160","120","60","50","30","0","420","35417",30
"13740","90","50","40","30","40","0","250","42500",20
"13743","670","440","280","170","180","0","1740","36364",140
"13744","200","160","80","70","50","0","560","37500",60
"13746","470","300","220","130","160","0","1280","39167",130
"13748","690","430","290","180","180","20","1790","36919",140
"13750","210","120","70","40","30","0","470","30208",40
"13751","50","40","30","0","0","0","120","31250",0
"13752","120","80","60","30","30","0","320","37500",20
"13753","740","490","270","180","200","40","1920","36224",110
"13754","620","310","200","110","110","0","1350","29435",140
"13755","230","160","80","60","40","0","570","33594",40
"13756","100","60","50","0","20","0","230","31250",30
"13757","170","100","70","40","50","0","430","36250",30
"13760","8360","4980","3030","1980","2600","490","21440","36847",1410
"13775","260","210","110","70","100","0","750","38690",40
"13776","140","80","60","30","40","0","350","35938",20
"13777","160","90","60","40","40","0","390","34722",40
"13778","990","730","400","260","270","30","2680","36986",240
"13780","160","120","80","50","50","0","460","39583",30
"13782","140","70","50","30","30","0","320","32143",20
"13783","460","250","150","100","70","0","1030","30500",130
"13786","60","50","20","40","0","0","170","37500",0
"13787","630","440","220","130","110","0","1530","32670",150
"13788","150","120","70","30","50","0","420","37500",30
"13790","3870","2290","1190","640","600","90","8680","30131",540
"13795","760","440","250","170","150","20","1790","32670",150
"13796","240","140","90","60","50","0","580","33929",50
"13797","370","250","140","80","80","0","920","34000",100
"13801","220","170","80","40","30","0","540","32353",50
"13802","160","100","50","50","50","0","410","36250",30
"13803","700","530","270","190","140","0","1830","35142",180
"13804","70","70","30","30","0","0","200","35714",0
"13806","50","20","30","0","0","0","100","25000",0
"13807","260","150","90","50","70","0","620","33333",40
"13808","320","200","120","80","70","0","790","34375",60
"13809","280","200","110","70","50","0","710","34375",60
"13810","210","150","80","50","40","0","530","34167",40
"13811","770","520","300","180","220","0","1990","35817",190
"13812","400","260","190","100","90","0","1040","36538",110
"13813","190","80","80","40","30","0","420","31250",30
"13815","2550","1570","830","470","540","110","6070","32723",340
"13820","3180","1900","1070","710","820","150","7830","34671",490
"13825","600","390","230","140","160","0","1520","35256",120
"13827","2020","1270","740","540","640","100","5310","37500",380
"13830","840","610","340","190","190","0","2170","35041",170
"13832","110","90","30","40","0","0","270","31944",30
"13833","740","540","310","180","180","0","1950","35880",190
"13835","270","180","110","60","50","0","670","34028",70
"13838","850","480","280","150","170","20","1950","31510",140
"13839","220","180","100","50","50","0","600","36111",50
"13841","100","60","40","40","0","0","240","33333",40
"13842","80","50","30","30","20","0","210","37500",0
"13843","320","210","130","70","60","0","790","33929",80
"13844","150","90","40","30","20","0","330","29167",30
"13846","50","60","0","30","0","0","140","33333",0
"13849","790","510","330","200","150","30","2010","35539",170
"13850","3270","2000","1390","1120","1660","560","10000","46625",490
"13856","1160","700","400","230","190","20","2700","31786",210
"13861","120","70","40","40","40","0","310","37500",30
"13862","690","510","270","180","190","0","1840","36275",180
"13863","100","50","30","20","0","0","200","25000",40
"13864","210","160","80","40","30","0","520","32812",40
"13865","1110","640","450","270","260","20","2750","35352",220
"13901","3790","1910","1170","690","920","140","8620","31806",550
"13903","3650","2030","1150","670","850","250","8600","33005",600
"13904","1850","1060","610","340","320","40","4220","31132",310
"13905","5160","2530","1410","810","920","220","11050","28607",670
"14001","1750","1150","730","510","590","80","4810","39239",410
"14004","1750","1230","860","660","770","80","5350","43801",400
"14005","360","220","170","90","100","0","940","37500",70
"14006","1850","1190","750","490","480","50","4810","36660",450
"14008","270","180","110","60","80","0","700","36111",70
"14009","980","730","400","270","220","30","2630","36473",310
"14011","1030","700","480","320","340","20","2890","39821",270
"14012","420","270","190","100","110","0","1090","36574",120
"14013","280","200","120","50","60","0","710","34375",80
"14020","4260","2540","1400","900","880","140","10120","32874",710
"14024","250","200","120","80","70","0","720","38750",90
"14025","470","340","260","190","250","50","1560","47794",120
"14026","140","90","50","50","50","0","380","38889",30
"14028","240","180","110","80","100","0","710","40972",80
"14030","290","220","120","70","70","0","770","35795",100
"14031","1610","870","620","470","810","460","4840","48276",260
"14032","1230","620","380","440","940","490","4100","63158",200
"14033","350","240","170","150","220","30","1160","48958",110
"14034","310","220","150","110","80","0","870","39205",80
"14036","850","600","370","280","280","30","2410","39792",200
"14037","190","140","100","70","90","0","590","43750",70
"14040","410","260","190","110","160","0","1130","39904",110
"14041","60","30","20","0","0","0","110","22917",0
"14042","700","470","280","150","110","0","1710","33245",250
"14043","4590","3590","2230","1330","1190","90","13020","38370",880
"14047","1080","740","500","380","420","60","3180","42230",280
"14048","3070","1670","780","510","400","40","6470","27470",550
"14051","2880","1360","1060","1090","2520","1200","10110","69222",410
"14052","2900","1640","1210","1030","1730","540","9050","49771",470
"14054","220","170","120","70","70","0","650","40441",50
"14055","240","170","110","100","100","0","720","42647",60
"14057","1400","910","610","460","680","100","4160","43681",280
"14058","340","280","170","120","130","0","1040","41071",70
"14059","1530","960","680","630","920","240","4960","49740",300
"14060","70","60","40","30","0","0","200","37500",30
"14062","600","390","240","140","150","0","1520","35256",150
"14063","1850","1120","750","540","700","100","5060","40179",310
"14065","300","200","150","80","40","0","770","35625",110
"14066","190","120","90","50","40","0","490","36458",50
"14067","860","580","400","250","280","30","2400","39655",250
"14068","1130","580","420","370","770","290","3560","54167",160
"14069","120","110","60","60","80","0","430","46591",40
"14070","910","650","350","210","190","0","2310","34423",210
"14072","3210","2060","1430","1280","2070","540","10590","50437",600
"14075","7620","4690","3260","2590","3510","660","22330","43897",1460
"14080","670","490","340","260","320","30","2110","44643",210
"14081","510","350","180","80","110","0","1230","32500",130
"14082","80","60","50","30","20","0","240","41667",30
"14085","1080","670","560","520","840","120","3790","56473",290
"14086","5490","3290","2450","1960","3500","540","17230","48746",1010
"14091","210","170","100","50","60","0","590","37500",60
"14092","1780","1160","840","660","930","240","5610","47091",340
"14094","9470","6050","3600","2370","2800","370","24660","36818",2130
"14098","510","370","210","130","140","0","1360","36486",160
"14101","330","220","130","70","50","0","800","32955",80
"14102","240","140","90","80","120","0","670","41964",50
"14103","2160","1330","710","430","370","30","5030","31673",430
"14105","790","570","320","220","190","20","2110","36623",220
"14108","990","730","450","290","280","30","2770","38527",300
"14111","570","390","260","170","180","0","1570","38782",160
"14113","130","110","80","50","40","0","410","42045",40
"14120","8190","5430","3320","2350","2940","390","22620","39365",1610
"14125","660","440","280","180","190","0","1750","37216",170
"14127","4710","2810","2050","1660","3030","1380","15640","53659",770
"14129","200","170","100","60","60","0","590","38971",70
"14131","950","630","380","280","330","40","2610","39087",270
"14132","1010","700","490","320","360","40","2920","41071",260
"14134","60","40","30","30","0","0","160","37500",0
"14136","930","570","340","240","200","0","2280","34211",230
"14138","350","210","130","70","70","0","830","32738",90
"14139","380","240","170","150","190","30","1160","45833",90
"14141","1380","950","620","350","380","70","3750","38026",280
"14143","210","170","90","100","80","0","650","41912",50
"14145","240","190","150","100","90","0","770","44079",70
"14150","8080","6010","3650","2290","1920","150","22100","37354",1440
"14167","250","210","140","100","90","0","790","42262",80
"14170","370","270","210","160","210","40","1260","49074",110
"14171","370","260","160","90","90","0","970","36058",110
"14172","530","360","260","190","200","30","1570","42708",160
"14174","930","570","430","340","490","120","2880","47368",190
"14201","2580","1240","400","210","200","50","4680","22674",330
"14202","670","430","150","120","160","180","1710","35756",80
"14203","350","210","100","60","60","30","810","31548",40
"14204","2030","750","280","130","100","0","3290","20259",290
"14206","4620","2830","1110","570","300","0","9430","25839",790
"14207","5820","2520","730","290","160","0","9520","20447",810
"14208","2310","980","340","110","80","0","3820","20671",290
"14209","1430","970","430","200","280","170","3480","32990",160
"14210","3280","1850","720","300","160","0","6310","24047",620
"14211","5630","2080","590","210","110","0","8620","19139",690
"14212","2590","1070","340","160","80","0","4240","20463",340
"14213","5780","2270","690","270","180","30","9220","19939",670
"14214","3560","1820","870","540","710","230","7730","29190",420
"14215","9510","4720","1570","680","470","30","16980","22319",1340
"14216","4110","3200","1700","940","1020","290","11260","36875",690
"14217","4170","3180","1940","1270","1100","140","11800","38601",760
"14218","4240","2540","1160","570","450","0","8960","27362",670
"14219","2370","1720","990","600","450","30","6160","35320",500
"14220","4750","3350","1720","980","880","50","11730","33321",940
"14221","8100","4520","3820","3140","5470","2160","27210","56446",1060
"14222","1860","1680","910","520","720","410","6100","42708",270
"14223","4200","3070","2120","1470","1440","120","12420","41368",720
"14224","7170","5260","3390","2610","2860","260","21550","42134",1390
"14225","6910","5260","2860","1570","1060","60","17720","34268",1260
"14226","4800","3090","2200","1520","2150","770","14530","44943",660
"14227","4250","3250","2060","1270","1110","60","12000","38462",780
"14228","3380","2070","1250","940","1270","320","9230","39915",440
"14301","3090","1280","400","190","120","0","5080","20550",450
"14303","1470","640","200","100","40","0","2450","20833",240
"14304","6240","3960","2230","1350","1340","130","15250","33744",1180
"14305","3720","1760","850","470","440","50","7290","24496",650
"14411","2330","1480","780","490","390","40","5510","32179",510
"14414","1180","870","520","330","510","60","3470","40948",220
"14416","650","460","310","240","240","0","1900","41304",150
"14418","210","130","90","50","70","0","550","37500",40
"14420","2890","1770","1190","830","990","140","7810","39336",470
"14422","350","290","160","120","130","20","1070","40948",80
"14423","830","560","370","270","280","30","2340","40179",180
"14424","4870","3050","1900","1300","1840","510","13470","40287",750
"14425","2020","1340","940","660","830","100","5890","42257",380
"14427","360","240","160","110","90","0","960","37500",70
"14428","1390","1000","680","540","730","70","4410","45375",240
"14432","950","660","430","270","260","30","2600","38258",210
"14433","850","560","300","160","160","0","2030","32366",150
"14435","450","390","220","150","210","40","1460","42949",120
"14437","1720","1140","690","390","360","50","4350","34978",360
"14441","60","50","30","0","20","0","160","35000",0
"14445","1620","1180","670","300","260","50","4080","33898",260
"14450","6400","3850","2860","2480","4610","1320","21520","54458",890
"14454","1010","590","440","350","510","110","3010","45975",140
"14456","3950","2100","1090","730","850","160","8880","30833",650
"14462","90","70","60","40","40","0","300","46429",0
"14464","1250","910","540","370","350","30","3450","38049",260
"14466","330","180","120","110","120","0","860","38889",50
"14467","1730","1130","720","550","590","80","4800","39823",230
"14468","2980","2060","1450","1180","1410","200","9280","45146",520
"14469","1060","690","460","300","390","50","2950","40036",210
"14470","1390","1020","580","390","300","30","3710","36397",290
"14471","490","330","190","150","170","30","1360","39394",120
"14472","1330","690","510","410","880","460","4280","55882",170
"14475","60","20","20","20","40","0","160","50000",0
"14476","350","260","180","110","120","0","1020","40385",70
"14477","300","180","120","70","90","0","760","36111",80
"14478","150","110","80","40","80","0","460","43182",30
"14480","210","110","70","40","50","0","480","31818",40
"14481","320","230","150","100","100","0","900","39130",70
"14482","1540","1020","640","420","430","60","4110","37623",270
"14485","730","480","300","240","240","30","2020","39583",110
"14486","40","40","20","20","20","0","140","43750",0
"14487","1000","600","490","330","460","70","2950","44792",180
"14489","1280","930","480","250","250","0","3190","33468",260
"14502","1720","1120","730","600","900","120","5190","44531",320
"14504","360","280","140","70","50","0","900","33036",80
"14505","950","650","420","290","290","0","2600","38462",200
"14506","170","90","60","70","170","70","630","72917",30
"14507","250","170","110","60","60","0","650","36029",60
"14510","930","570","320","210","160","0","2190","32237",260
"14512","920","500","350","240","210","50","2270","35750",210
"14513","2780","1720","940","510","480","40","6470","31613",460
"14514","930","680","440","340","470","60","2920","44485",150
"14516","390","290","160","110","110","0","1060","37069",80
"14517","530","310","190","140","130","0","1300","34677",120
"14519","1880","1380","880","690","970","140","5940","44746",420
"14521","490","350","190","100","110","0","1240","34286",80
"14522","1700","1190","650","430","430","60","4460","36134",350
"14525","430","350","240","160","140","0","1320","41429",120
"14526","3090","1810","1450","1190","2320","720","10580","56724",420
"14527","2380","1510","820","500","520","100","5830","33858",330
"14530","920","700","410","240","170","40","2480","36429",250
"14532","800","540","330","270","220","30","2190","38657",150
"14533","260","220","120","80","90","0","770","39205",60
"14534","4150","1920","1600","1660","3890","2810","16030","80196",450
"14536","110","80","50","50","0","0","290","35938",30
"14541","360","280","160","110","110","20","1040","39286",50
"14543","530","380","240","210","320","80","1760","48026",80
"14544","340","240","140","90","80","30","920","37500",50
"14546","790","650","420","290","300","70","2520","43077",170
"14548","740","550","300","190","200","0","1980","36364",150
"14550","290","200","140","60","70","0","760","36250",90
"14551","1080","700","370","220","170","20","2560","32143",260
"14555","160","120","80","50","80","0","490","42708",40
"14559","3060","1890","1400","1000","1540","280","9170","45172",520
"14560","370","260","150","110","120","0","1010","37981",110
"14561","470","330","220","160","140","0","1320","39394",90
"14564","2260","1230","900","650","1610","840","7490","57083",300
"14568","940","650","500","420","520","40","3070","47885",190
"14569","1120","720","450","290","280","40","2900","36458",230
"14571","240","150","90","60","60","0","600","35000",60
"14572","870","610","360","220","190","0","2250","35451",240
"14580","8310","5060","3840","3170","5130","1290","26800","50195",1140
"14585","60","60","0","30","0","0","150","31250",0
"14586","1430","1070","890","690","920","70","5070","50983",250
"14589","1360","870","600","360","430","70","3690","38937",200
"14590","930","600","340","210","180","30","2290","33958",210
"14591","280","190","140","80","90","0","780","39474",50
"14604","370","260","120","60","50","40","900","32692",50
"14605","2930","850","140","40","50","0","4010","17108",340
"14606","6200","3710","1800","910","620","30","13270","27931",1000
"14607","3240","2920","1080","420","460","190","8310","32834",420
"14608","3030","1100","340","130","100","40","4740","19554",350
"14609","9210","5790","2640","1330","1000","90","20060","28541",1420
"14610","2110","1750","1160","810","1130","650","7610","49214",290
"14611","4250","1660","420","150","90","0","6570","19324",490
"14612","6110","4500","2680","1980","2300","340","17910","40806",1080
"14613","3510","1390","430","160","120","0","5610","19979",460
"14614","90","50","40","0","50","0","230","37500",0
"14615","3700","2570","980","470","360","20","8100","28405",580
"14616","5770","4510","2350","1190","930","90","14840","34146",1000
"14617","4210","2710","2000","1460","1810","260","12450","43589",660
"14618","2730","1700","1400","1150","2180","1220","10380","63571",330
"14619","3320","2020","750","310","230","0","6630","24962",480
"14620","4150","3310","1640","780","860","190","10930","34932",530
"14621","7790","3150","810","260","160","0","12170","19528",990
"14622","2360","1850","1120","680","600","90","6700","38378",430
"14623","3700","2630","1660","860","660","50","9560","35266",500
"14624","6500","4890","3300","2160","2410","260","19520","41667",1100
"14625","1660","1040","790","620","1100","310","5520","51899",210
"14626","5620","3760","2420","1670","1950","350","15770","40060",800
"14701","8150","3830","2130","1190","1020","180","16500","25653",1250
"14706","1040","580","430","260","370","100","2780","40086",190
"14709","270","170","100","60","50","0","650","33088",50
"14710","630","400","270","150","160","20","1630","36562",130
"14711","250","210","130","60","40","0","690","36310",60
"14712","570","300","200","160","220","70","1520","40833",90
"14714","70","40","30","20","0","0","160","31250",0
"14715","510","270","160","110","70","0","1120","29630",100
"14716","440","270","110","80","60","0","960","28704",80
"14717","130","70","60","50","0","0","310","33929",30
"14718","360","230","150","100","90","0","930","36413",80
"14719","560","400","210","130","120","0","1420","34375",150
"14723","220","150","90","60","40","0","560","35000",60
"14724","400","250","180","80","80","0","990","34500",70
"14726","190","120","60","40","0","0","410","28125",40
"14727","910","560","340","230","200","30","2270","35045",180
"14728","190","100","80","50","40","0","460","35000",30
"14729","150","120","80","30","40","0","420","37500",40
"14731","280","160","100","70","100","40","750","39844",60
"14733","830","480","250","140","110","0","1810","28906",150
"14735","430","260","160","80","80","0","1010","32212",100
"14736","90","60","40","30","30","0","250","39583",0
"14737","710","450","250","150","120","0","1680","32222",220
"14738","690","430","270","170","130","0","1690","34012",130
"14739","550","270","160","80","60","0","1120","25926",100
"14740","220","130","90","60","40","0","540","34615",40
"14741","400","200","130","80","100","0","910","31875",70
"14743","310","190","130","90","60","0","780","35526",70
"14744","180","110","90","50","40","0","470","37500",0
"14747","400","280","150","80","60","0","970","32589",100
"14748","140","80","30","40","0","0","290","26562",30
"14750","810","460","340","240","310","120","2280","42935",130
"14753","220","140","80","40","40","0","520","32143",40
"14754","110","80","40","50","0","0","280","34375",20
"14755","560","330","190","100","90","0","1270","30682",120
"14757","630","350","220","140","130","30","1500","33571",130
"14760","3750","1910","1160","690","670","140","8320","30366",540
"14767","310","190","100","60","60","0","720","31579",50
"14769","170","110","60","30","30","0","400","31818",40
"14770","560","320","230","120","110","20","1360","34375",140
"14772","630","490","240","140","120","20","1640","34694",170
"14775","460","300","190","80","60","0","1090","32083",90
"14777","110","80","50","20","30","0","290","35938",30
"14779","1480","820","350","190","130","0","2970","25152",320
"14781","410","200","140","70","70","0","890","29375",80
"14782","400","260","150","70","70","0","950","32212",120
"14784","190","100","60","40","20","0","410","28750",30
"14787","1010","520","330","230","180","30","2300","31731",150
"14801","920","550","350","210","190","0","2220","33636",240
"14802","180","60","50","40","60","0","390","31250",0
"14803","190","120","100","50","70","0","530","40625",50
"14804","220","160","110","70","70","0","630","39844",50
"14805","200","140","100","50","60","0","550","38393",40
"14806","380","200","190","100","100","0","970","38125",110
"14807","500","350","240","130","150","0","1370","38214",130
"14808","130","90","40","30","0","0","290","29167",40
"14809","430","320","160","90","80","0","1080","33594",100
"14810","2220","1230","760","470","420","40","5140","32114",400
"14812","600","360","250","140","150","0","1500","35417",140
"14813","470","240","150","90","90","0","1040","30208",90
"14814","280","170","150","150","190","50","990","57500",50
"14815","160","110","70","40","40","0","420","36364",30
"14816","110","70","60","30","40","0","310","41071",20
"14817","430","360","180","150","150","0","1270","39236",60
"14818","320","230","150","80","90","20","890","38587",60
"14819","130","70","40","30","0","0","270","26786",30
"14820","120","70","50","50","0","0","290","33929",30
"14821","600","380","240","150","180","0","1550","36513",150
"14822","200","170","60","50","30","0","510","33088",60
"14823","650","410","290","140","140","0","1630","35061",170
"14824","130","90","70","30","20","0","340","36111",0
"14825","140","100","60","40","30","0","370","36250",20
"14826","350","230","150","80","90","0","900","35870",110
"14830","3530","2190","1450","870","1170","390","9600","39498",600
"14836","140","120","90","50","50","0","450","42708",60
"14837","950","540","340","170","160","30","2190","31713",150
"14838","330","220","150","100","90","0","890","38068",80
"14839","110","90","30","30","30","0","290","34722",20
"14840","510","360","230","150","210","60","1520","42361",120
"14841","180","120","50","40","60","0","450","34375",30
"14842","120","80","60","40","50","0","350","42188",0
"14843","2570","1370","780","450","400","50","5620","29380",470
"14845","3450","2170","1580","1110","1450","400","10160","43779",540
"14846","120","90","40","50","0","0","300","33333",30
"14847","410","310","160","110","90","20","1100","36290",40
"14850","7720","5470","2870","1880","3270","1540","22750","41705",610
"14853","60","70","0","20","0","0","150","30357",0
"14855","160","90","50","40","20","0","360","30556",30
"14858","280","140","120","90","90","0","720","39286",60
"14859","190","130","80","50","40","0","490","35577",40
"14860","200","130","70","50","60","0","510","35577",30
"14861","250","190","100","60","60","0","660","35526",40
"14864","220","140","70","50","50","0","530","33036",40
"14865","480","270","180","110","120","0","1160","34259",100
"14867","1060","720","420","250","220","30","2700","35069",140
"14869","270","150","100","60","60","0","640","33333",50
"14870","1540","840","650","460","760","290","4540","46726",240
"14871","690","420","410","270","340","40","2170","48512",90
"14872","110","70","40","20","20","0","260","32143",20
"14873","390","300","160","80","100","0","1030","35417",120
"14874","50","40","0","20","0","0","110","28125",0
"14877","80","50","30","40","0","0","200","35000",0
"14878","120","80","40","30","30","0","300","34375",20
"14879","400","240","170","100","80","0","990","34896",100
"14880","280","180","100","80","50","0","690","34028",70
"14881","50","50","20","30","0","0","150","37500",0
"14882","600","440","310","220","290","90","1950","46307",90
"14883","670","510","300","170","170","0","1820","36765",130
"14884","60","40","30","20","0","0","150","34375",0
"14885","130","90","50","40","0","0","310","31944",30
"14886","1130","780","520","350","460","100","3340","42308",120
"14889","270","180","100","70","50","0","670","34028",50
"14891","830","500","290","200","180","30","2030","34250",200
"14892","1640","910","490","300","300","40","3680","30495",280
"14894","260","150","110","70","60","0","650","35833",60
"14895","1740","940","590","350","390","60","4070","32846",270
"14897","150","80","60","40","40","0","370","35938",30
"14898","270","150","90","60","50","0","620","31667",50
"14901","2970","1280","650","310","280","40","5530","23274",350
"14903","1380","890","560","340","390","150","3710","38343",240
"14904","3380","1940","1000","490","330","0","7140","27448",470
"14905","1510","900","680","450","640","190","4370","43750",190
