"ZIP","0_25000","25000_50000","50000_75000","75000_100000","100000_200000","200000_","nbrReturns","medianInc","jl_benef"
"00000","3553130","2091460","1274200","817760","1233950","521240","9491740","39257",321780
"10001","3760","2430","1930","1340","2480","2370","14310","62500",420
"10002","22380","8260","4690","2690","3530","1640","43190","24123",1060
"10003","5320","4020","4340","3340","6580","6450","30050","85067",650
"10004","340","260","290","200","520","880","2490","129808",50
"10005","750","750","910","660","1360","1730","6160","100735",100
"10006","300","320","360","260","650","540","2430","97596",40
"10007","440","280","230","220","570","1590","3330","186842",60
"10009","10130","6860","5800","3710","5100","2110","33710","49508",1030
"10010","2650","2430","2570","1950","3950","3930","17480","88974",350
"10011","5130","3630","3770","3260","6970","7540","30300","95092",780
"10012","2490","1840","1740","1420","2790","2580","12860","81338",270
"10013","4530","2070","1570","1140","2040","3740","15090","65048",240
"10014","2880","2250","2460","2110","4620","4790","19110","98282",470
"10016","4970","4780","5220","3880","7210","6370","32430","83022",610
"10017","1850","1450","1530","1290","2840","3320","12280","100704",240
"10018","1460","1060","800","640","1220","1290","6470","72344",140
"10019","5010","3680","3380","2570","5270","4940","24850","78453",790
"10021","3660","2840","3190","2520","4970","7000","24180","98810",420
"10022","2880","2120","2440","2100","4630","6060","20230","112419",380
"10023","5970","3840","3800","3320","7350","9820","34100","101633",840
"10024","6030","3750","3610","2840","6280","8590","31100","94014",730
"10025","12960","8230","6330","4180","7580","7460","46740","58610",1300
"10026","7380","4240","2520","1440","1840","980","18400","35731",680
"10027","11980","6610","3490","1770","2380","1280","27510","31713",890
"10028","4160","3160","3790","2930","5400","6430","25870","90572",510
"10029","17180","9220","4610","1820","1770","850","35450","26478",1190
"10030","6800","3670","1770","730","660","180","13810","25715",540
"10031","14490","7980","3800","1640","1430","390","29730","26175",1200
"10032","15190","7980","3620","1470","1400","310","29970","24663",1190
"10033","13370","6500","3240","1530","1910","620","27170","25827",1160
"10034","9900","4750","2760","1350","1470","290","20520","26895",880
"10035","7560","3750","1850","930","990","300","15380","25867",560
"10036","4460","3170","2510","2020","3710","2780","18650","66882",670
"10037","4120","2750","1910","1010","910","130","10830","36773",410
"10038","3490","1950","1660","1120","2210","1780","12210","60015",260
"10039","6670","3570","1750","750","680","160","13580","25840",500
"10040","10370","5310","2840","1360","1370","360","21610","27048",950
"10044","1180","750","620","450","850","460","4310","59073",110
"10065","2310","2110","2150","1680","3220","4460","15930","95759",240
"10069","370","220","220","180","560","1280","2830","175893",50
"10075","2200","1710","2030","1650","3070","3770","14430","94318",310
"10128","5910","4750","5000","3690","6410","7740","33500","82385",660
"10162","100","60","50","60","180","300","750","158333",0
"10280","520","400","430","450","1210","1340","4350","130992",130
"10282","220","120","140","110","390","1350","2330",NA,30
"10301","6630","3830","2600","1690","2480","850","18080","40731",520
"10302","3410","1750","1120","660","990","140","8070","33929",220
"10303","5400","2850","1630","1010","1210","100","12200","31140",370
"10304","8300","4130","2420","1470","2290","890","19500","33777",520
"10305","6770","4020","2820","2030","3010","590","19240","42724",660
"10306","8330","5050","3840","2950","5240","1300","26710","49876",900
"10307","1880","1020","860","640","1490","550","6440","59302",230
"10308","3820","2340","1950","1660","3080","720","13570","58013",490
"10309","4100","2550","2050","1630","3480","1090","14900","59756",570
"10310","4420","2350","1400","1030","1830","430","11460","38936",320
"10312","8070","5020","4060","3460","6890","1750","29250","59452",1100
"10314","12450","7950","5790","4650","7880","1810","40530","49575",1280
"10451","12670","6360","2560","1000","700","60","23350","23037",900
"10452","22230","9340","3330","960","500","30","36390","20462",1410
"10453","23970","9430","3030","880","560","0","37870","19749",1480
"10454","10000","4070","1260","330","230","20","15910","19888",560
"10455","10630","4830","1660","510","270","0","17900","21049",730
"10456","25320","10540","3190","950","520","20","40540","20014",1620
"10457","20850","8230","2670","800","460","30","33040","19808",1170
"10458","20400","8850","3360","1130","760","40","34540","21164",1200
"10459","12480","5840","1890","650","350","20","21230","21264",920
"10460","14970","6420","2210","770","480","30","24880","20775",1000
"10461","8690","6040","4130","2260","2530","330","23980","38659",810
"10462","16630","10840","6760","3060","2360","150","39800","32542",1340
"10463","12800","7360","5010","3130","4270","1440","34010","39283",1130
"10464","570","390","350","250","420","160","2140","57857",90
"10465","6330","4370","3280","2150","3060","530","19720","45195",720
"10466","15260","9320","4360","2090","1890","110","33030","28366",1040
"10467","22520","12310","5640","2140","1690","110","44410","24650",1440
"10468","20960","9050","3530","1320","840","50","35750","21320",1260
"10469","13790","8530","4760","2530","2690","300","32600","32356",950
"10470","2960","1840","1210","660","860","130","7660","36821",230
"10471","2360","1620","1530","1260","2060","1060","9890","65768",250
"10472","16550","7480","2890","1010","720","40","28690","21669",1010
"10473","12990","7670","3780","1790","1620","110","27960","28227",1180
"10474","3010","1380","470","130","70","0","5060","21013",190
"10475","7370","6360","4630","2400","1790","100","22650","40546",610
"10501","170","90","70","60","150","140","680","79167",0
"10502","700","280","250","240","640","730","2840","94792",60
"10504","1080","380","330","270","800","2560","5420","181250",90
"10505","190","100","50","40","100","120","600","55000",20
"10506","700","250","190","150","440","1050","2780","122727",50
"10507","890","490","330","200","440","360","2710","48724",80
"10509","3080","1710","1260","970","2110","850","9980","53968",280
"10510","1090","470","400","290","1020","1550","4820","115686",120
"10511","340","210","170","110","230","80","1140","52941",30
"10512","3420","2190","1760","1340","2880","900","12490","59020",400
"10514","1240","390","330","250","840","2380","5430","160119",70
"10516","700","420","330","280","650","340","2720","68182",80
"10518","180","70","70","50","160","170","700","90000",0
"10520","1600","950","750","580","1390","1150","6420","72000",170
"10522","1200","790","670","500","1100","940","5200","72761",140
"10523","1580","940","720","490","840","270","4840","47340",110
"10524","490","290","230","220","500","310","2040","76136",60
"10526","260","130","110","70","210","200","980","72727",30
"10527","100","50","30","30","120","100","430","104167",0
"10528","1550","940","770","530","980","1120","5890","64773",160
"10530","1420","1010","1020","870","1820","1020","7160","78736",200
"10532","630","410","320","250","700","300","2610","70703",70
"10533","840","420","380","340","770","1060","3810","94485",80
"10535","130","90","70","40","70","0","400","44444",0
"10536","1400","520","470","350","1000","1500","5240","91429",90
"10537","390","260","170","150","230","30","1230","46635",50
"10538","1770","760","650","590","1300","2990","8060","120000",150
"10541","3600","1960","1550","1290","3110","1070","12580","61774",420
"10543","2840","1570","1140","870","1670","1600","9690","59539",270
"10546","150","80","70","60","160","200","720","100000",30
"10547","1030","640","480","350","810","260","3570","55990",130
"10548","430","260","220","170","390","120","1590","61932",50
"10549","2700","1450","830","580","1240","1460","8260","49655",170
"10550","9030","5510","2520","1170","990","90","19310","27836",710
"10552","3020","2260","1790","1260","1840","660","10830","51885",330
"10553","2200","1590","850","490","600","90","5820","36164",160
"10560","530","300","240","170","450","450","2140","75000",60
"10562","5070","3260","2120","1500","2670","1260","15880","47009",400
"10566","4430","2890","1720","1070","1590","330","12030","38711",390
"10567","2500","1370","1070","930","2340","1270","9480","70327",270
"10570","1570","700","610","460","1200","1470","6010","81793",140
"10573","7160","4280","2270","1290","2210","1790","19000","38668",700
"10576","590","230","190","180","500","830","2520","114000",60
"10577","410","170","130","90","180","630","1610","102778",30
"10578","110","70","60","30","120","50","440","66667",0
"10579","1070","670","570","480","1080","470","4340","68860",130
"10580","1970","780","610","500","1170","3030","8060","114530",130
"10583","4270","1680","1640","1290","3320","6730","18930","117620",330
"10588","330","200","180","130","310","110","1260","63889",40
"10589","950","590","630","530","1210","700","4610","81368",100
"10590","790","340","300","260","750","730","3170","89904",90
"10591","3700","2340","1470","1060","1940","1520","12030","49733",420
"10594","650","370","310","230","600","370","2530","69758",60
"10595","780","470","400","300","770","500","3220","72500",80
"10597","130","40","30","30","70","200","500","128571",0
"10598","3660","2040","1640","1330","3770","2020","14460","73323",430
"10601","1810","1180","880","560","960","710","6100","51705",140
"10603","3000","1980","1520","1090","1870","700","10160","51645",310
"10604","1770","1070","770","510","850","660","5630","49416",160
"10605","2580","1520","1210","900","2140","1930","10280","71488",220
"10606","3150","1910","1050","570","1040","660","8380","38613",190
"10607","1090","740","510","340","780","480","3940","56863",110
"10701","12690","7100","3750","2010","2720","520","28790","31004",1190
"10703","3880","2510","1490","1020","1430","220","10550","38894",360
"10704","4990","3700","2980","1990","2760","500","16920","48446",530
"10705","8210","4540","2430","1230","1540","390","18340","30286",680
"10706","970","560","470","410","1000","1080","4490","89939",110
"10707","1310","720","690","520","1130","760","5130","69384",160
"10708","2320","1510","1540","1230","2370","2470","11440","82114",240
"10709","1200","670","570","470","1070","840","4820","73684",130
"10710","3680","2740","2210","1720","2940","840","14130","57296",390
"10801","7140","4080","2510","1600","2410","920","18660","38419",850
"10803","1400","800","610","460","1030","1720","6020","85870",140
"10804","1520","700","650","520","1460","2280","7130","111986",120
"10805","2920","2050","1560","1080","1320","360","9290","46037",380
"10901","3290","1920","1430","1060","2430","1380","11510","59528",340
"10913","700","350","270","230","620","420","2590","72685",80
"10916","610","330","240","230","540","210","2160","64583",60
"10917","290","170","130","90","210","110","1000","57692",30
"10918","1620","950","750","590","1210","390","5510","56167",180
"10919","200","140","70","60","110","20","600","42857",20
"10920","1310","690","550","480","1070","400","4500","61364",150
"10921","620","380","300","230","480","110","2120","55000",80
"10923","1580","1090","690","470","820","180","4830","44151",180
"10924","1880","1070","750","600","1340","550","6190","54833",140
"10925","740","480","380","300","520","80","2500","51974",120
"10926","590","370","310","200","370","110","1950","51210",50
"10927","3040","1570","630","320","430","100","6090","25080",320
"10928","800","580","330","230","300","50","2290","39871",80
"10930","1280","640","490","460","1120","400","4390","64031",160
"10931","170","100","70","60","80","0","480","42500",30
"10940","9170","5900","3350","2180","3060","440","24100","37203",750
"10941","2300","1680","1060","720","1110","180","7050","43229",200
"10950","6920","2950","1860","1550","3330","1130","17740","41525",430
"10952","5540","2370","1190","810","1530","1070","12510","32542",210
"10954","3690","2220","1620","1290","2670","930","12420","54630",380
"10956","4260","2160","1710","1440","4010","2480","16060","73538",460
"10958","520","270","250","170","340","90","1640","53000",50
"10960","2400","1470","1030","730","1400","790","7820","50971",230
"10962","720","370","330","260","570","350","2600","65909",70
"10963","390","240","180","150","220","30","1210","47396",40
"10964","180","120","70","60","170","170","770","81250",30
"10965","2050","1170","990","820","1950","840","7820","67424",260
"10968","270","180","180","170","310","200","1310","78676",40
"10969","210","120","100","70","100","30","630","46875",30
"10970","1510","1000","720","540","1020","360","5150","52257",180
"10973","340","200","140","130","240","60","1110","52679",30
"10974","490","290","200","160","330","120","1590","51875",50
"10975","50","30","50","20","20","0","170","52500",0
"10976","340","150","80","50","150","70","840","38333",0
"10977","11690","6080","2530","1530","2330","740","24900","28125",500
"10980","2090","1350","900","710","1560","540","7150","53750",280
"10983","740","420","340","280","810","360","2950","73162",80
"10984","330","210","160","150","360","90","1300","67188",50
"10985","40","40","30","20","40","0","170","54167",0
"10986","250","150","120","90","210","90","910","61458",20
"10987","700","250","180","150","400","280","1960","54167",60
"10989","1220","810","710","580","1220","440","4980","66197",180
"10990","2880","1610","1190","1000","2240","840","9760","58193",340
"10992","1410","790","610","510","1130","270","4720","56557",140
"10993","1050","660","360","200","290","0","2560","33712",90
"10994","990","530","460","380","900","570","3830","71467",100
"10996","390","130","170","220","260","50","1220","63235",0
"10998","450","270","200","190","360","80","1550","56875",50
"11001","3860","2280","1890","1460","3080","1260","13830","60251",390
"11003","8540","6040","3650","2400","2960","390","23980","39280",750
"11004","1960","1310","1060","890","1290","240","6750","52476",140
"11005","210","160","200","180","450","230","1430","95139",0
"11010","3530","2290","1890","1480","2790","630","12610","56415",370
"11020","920","460","260","210","550","700","3100","66346",40
"11021","2200","1280","1150","880","1960","1860","9330","75994",160
"11023","1020","490","430","310","760","900","3910","76210",40
"11024","930","460","300","210","480","770","3150","65417",30
"11030","1920","820","760","520","1410","3250","8680","122695",130
"11040","5600","3460","2670","2190","5110","2200","21230","64560",450
"11050","4100","2090","1530","1180","2720","3390","15010","71487",360
"11096","1930","950","470","290","260","40","3940","26053",150
"11101","5850","3380","2510","1550","2480","1270","17040","44749",510
"11102","7320","4650","3240","1810","2110","440","19570","38253",650
"11103","7600","5330","3960","2000","2110","380","21380","39493",710
"11104","5660","3540","2540","1480","1760","370","15350","39230",480
"11105","6620","4750","3460","2010","2400","590","19830","42342",660
"11106","8070","5280","3930","2130","2490","470","22370","39749",760
"11109","310","340","450","410","1170","980","3660","127350",70
"11201","6280","4020","3940","3210","6780","6670","30900","84424",760
"11203","16600","10930","5260","2530","2120","180","37620","30055",1140
"11204","17000","7500","3570","2030","2510","790","33400","24559",910
"11205","7310","4240","2710","1540","2100","900","18800","37323",630
"11206","18290","10180","4730","1890","1610","300","37000","25516",1260
"11207","23340","11740","4750","2080","1430","110","43450","23270",1590
"11208","24530","11950","4580","1740","1260","60","44120","22483",1440
"11209","11380","6540","5500","3850","5430","1870","34570","47573",970
"11210","12120","7640","4160","2170","2650","1150","29890","34244",920
"11211","10710","6910","4910","2960","4000","1820","31310","42891",900
"11212","21430","10440","4180","1570","1000","50","38670","22556",1360
"11213","14240","8320","3830","1630","1340","270","29630","26728",940
"11214","19720","9220","5010","2790","3190","590","40520","26464",1200
"11215","6700","5570","5320","3790","7000","5260","33640","71382",1040
"11216","11160","8340","4940","2220","2120","510","29290","35447",1010
"11217","4350","3330","2980","1990","3340","2520","18510","63213",580
"11218","13840","7230","4320","2710","3740","1250","33090","34353",830
"11219","21070","6970","2670","1420","1670","620","34420","20420",550
"11220","37090","9750","3620","1680","1740","390","54270","18290",970
"11221","18430","11050","5140","1960","1710","300","38590","26957",1310
"11222","6130","5110","4470","2520","3290","990","22510","50084",860
"11223","15710","7390","3680","2240","2620","1140","32780","27300",930
"11224","10160","4790","2290","1310","1320","260","20130","24766",680
"11225","12580","8620","4890","2150","1850","450","30540","32802",1010
"11226","24700","15080","6840","2900","2250","500","52270","27379",1780
"11228","8160","3810","2390","1680","2480","830","19350","34941",490
"11229","14790","8030","4710","3050","4400","1290","36270","35414",1010
"11230","15420","8150","4400","2490","3340","1530","35330","31887",900
"11231","4450","2920","2250","1610","3200","2500","16930","62167",620
"11232","6650","3140","1650","710","800","160","13110","24643",330
"11233","14710","8860","4200","1840","1460","240","31310","27666",1120
"11234","14670","9620","6220","4340","6040","1540","42430","42009",1270
"11235","16690","8230","4850","3080","4070","1320","38240","32382",1070
"11236","19840","13320","7030","3810","3560","340","47900","32714",1610
"11237","11390","7300","3100","1140","960","130","24020","27123",740
"11238","8100","6730","5490","3250","4510","2180","30260","51366",1030
"11239","2820","2040","1260","530","300","0","6950","33027",240
"11354","17920","5450","2820","1620","1830","430","30070","20975",490
"11355","34930","8220","3480","1820","1880","350","50680","18136",690
"11356","5940","2850","1520","830","1080","170","12390","27237",370
"11357","6190","3530","2730","2170","3860","1280","19760","51465",520
"11358","8050","3690","2270","1520","2550","740","18820","34214",410
"11360","2730","1540","1400","1210","2260","860","10000","63036",220
"11361","4860","2690","1910","1380","2220","710","13770","43820",350
"11362","2550","1530","1270","950","1830","590","8720","55512",190
"11363","940","570","440","330","640","460","3380","60227",60
"11364","5930","3380","2490","1900","2990","850","17540","46006",400
"11365","8540","4450","2660","1960","2790","610","21010","36039",650
"11366","2560","1250","870","640","1090","420","6830","42100",140
"11367","7800","4010","2600","1620","2100","600","18730","34757",460
"11368","28810","12220","4800","1780","1220","90","48920","21225",1080
"11369","9020","4530","2170","1050","920","90","17780","24640",540
"11370","6110","3110","1710","1000","1190","180","13300","29341",360
"11372","16460","8350","4610","2440","2750","640","35250","28488",960
"11373","28340","12160","5540","2580","2300","310","51230","22596",1020
"11374","8110","4790","3690","2430","3150","700","22870","42354",640
"11375","9270","6000","5650","4410","7280","3160","35770","61571",970
"11377","21790","10990","5960","3180","3310","500","45730","27445",1180
"11378","6840","3960","2520","1630","2180","400","17530","37153",630
"11379","5600","3560","2800","1930","3110","690","17690","47788",580
"11385","20700","12640","7330","3750","4150","540","49110","32625",1780
"11411","3850","2740","1790","1050","1250","130","10810","39188",300
"11412","7650","5340","2940","1560","1500","110","19100","33895",550
"11413","8160","5740","3400","2090","2140","190","21720","36760",580
"11414","3830","2750","2190","1630","2340","500","13240","50457",490
"11415","2930","2150","1710","1130","1380","310","9610","46802",310
"11416","6180","3250","1490","650","560","40","12170","24616",460
"11417","6440","3710","2060","1090","1300","130","14730","31233",520
"11418","8310","4460","2260","1120","1310","210","17670","27943",520
"11419","11910","6250","2710","1240","990","100","23200","24349",540
"11420","10140","6280","3150","1650","1570","140","22930","30275",630
"11421","9410","5210","2700","1390","1410","120","20240","28407",750
"11422","6130","4360","2640","1510","1690","170","16500","37156",500
"11423","6380","4060","2140","1150","1180","280","15190","32482",380
"11426","3250","1870","1300","970","1620","280","9290","43650",190
"11427","4170","2750","1810","1150","1470","350","11700","40273",270
"11428","3890","2600","1430","910","1010","100","9940","35385",250
"11429","5400","3730","1940","1080","960","80","13190","33009",350
"11430","50","40","40","30","0","0","160","43750",0
"11432","13700","6750","3360","1750","2050","670","28280","26630",620
"11433","8050","4450","2030","950","730","70","16280","25506",480
"11434","13110","9140","5240","2650","2100","140","32380","33425",940
"11435","12050","6540","3690","1930","1790","220","26220","29052",700
"11436","4180","2660","1410","670","590","30","9540","30545",270
"11501","2930","2030","1690","1230","2320","690","10890","57175",290
"11507","960","530","430","390","870","600","3780","73256",70
"11509","320","180","150","120","320","240","1330","78125",20
"11510","5280","3370","2510","1940","3800","1020","17920","53088",540
"11514","730","460","390","290","530","170","2570","56090",60
"11516","1000","490","420","320","680","460","3370","61607",80
"11518","1470","950","790","640","1220","530","5600","62025",150
"11520","9910","5710","3140","1960","2700","540","23960","34063",890
"11530","3410","1490","1400","1160","3150","3900","14510","95582",240
"11542","4830","2820","1710","1140","1990","910","13400","41578",420
"11545","1630","730","560","450","1130","1560","6060","81111",100
"11548","200","110","70","50","140","100","670","58929",0
"11550","13980","7570","3290","1730","1950","330","28850","26470",1080
"11552","4060","2530","1750","1290","2450","820","12900","48617",360
"11553","6430","4050","1910","1030","1040","90","14550","30216",510
"11554","5490","3650","2780","2120","4440","1290","19770","56700",550
"11557","1130","520","440","360","830","820","4100","72727",70
"11558","1380","840","580","390","820","230","4240","47024",150
"11559","1220","550","400","280","540","870","3860","60000",70
"11560","1000","520","340","290","570","710","3430","64338",60
"11561","5190","3160","2900","2420","4110","1720","19500","62069",620
"11563","3120","1970","1640","1330","2630","830","11520","60213",310
"11565","1130","690","610","500","1290","590","4810","73975",120
"11566","4650","2490","2140","1700","4570","2870","18420","74182",450
"11568","420","200","140","80","210","660","1710","107143",0
"11570","3780","2020","1700","1230","2940","2730","14400","70588",310
"11572","4420","2480","2020","1730","3860","1560","16070","64047",490
"11575","4270","2420","1170","620","600","50","9130","28048",320
"11576","1480","630","520","430","1130","2150","6340","109735",70
"11577","1540","790","590","520","1170","1400","6010","79087",100
"11579","690","380","290","250","570","460","2640","71552",50
"11580","6930","4650","3380","2450","3980","720","22110","47177",650
"11581","3060","1820","1440","1170","2430","820","10740","58507",280
"11590","9400","5680","3190","2020","3810","1320","25420","39569",770
"11596","1400","760","710","560","1270","780","5480","70423",130
"11598","1520","710","550","470","1200","1470","5920","84574",110
"11691","11260","5730","2650","1210","1290","280","22420","24889",660
"11692","4130","2290","1080","520","540","90","8650","27129",320
"11693","2360","1270","820","510","670","70","5700","34646",200
"11694","2710","1660","1200","910","1630","690","8800","50625",260
"11697","470","260","290","260","530","230","2040","75000",40
"11701","5630","3710","2000","1190","1680","450","14660","36456",490
"11702","2020","1150","1010","810","1860","880","7730","67203",240
"11703","2720","1940","1470","1100","1790","290","9310","49936",320
"11704","6580","4760","3270","2250","3520","540","20920","45378",820
"11705","1120","580","450","400","1040","480","4070","68611",90
"11706","12410","8490","4440","2720","3790","870","32720","36631",1310
"11709","1000","560","460","370","780","410","3580","62500",100
"11710","4920","2790","2300","1790","4360","1870","18030","64185",470
"11713","1980","1200","760","540","770","210","5460","40625",220
"11714","3570","2260","1740","1370","2760","720","12420","55460",380
"11715","620","330","290","260","640","230","2370","70259",60
"11716","1560","1040","810","600","1220","320","5550","55401",190
"11717","15350","10060","3870","1740","1440","110","32570","27324",1410
"11718","440","210","190","150","430","340","1760","81667",40
"11719","410","280","230","180","360","130","1590","61413",40
"11720","4510","2890","2070","1600","3020","640","14730","49697",520
"11721","810","430","350","300","790","650","3330","81250",80
"11722","8330","5290","2450","1400","1410","130","19010","30553",830
"11724","410","180","150","110","250","580","1680","97727",30
"11725","4000","2130","1700","1530","3720","1720","14800","68676",420
"11726","4700","2940","1410","810","1010","160","11030","31930",430
"11727","4360","3290","2310","1680","2620","380","14640","47492",620
"11729","4770","3340","2200","1600","2630","430","14970","45322",540
"11730","2100","1210","960","730","1720","650","7370","59766",250
"11731","4340","2350","1870","1550","3730","1560","15400","63503",460
"11732","420","270","230","180","450","300","1850","75694",50
"11733","2150","1090","810","750","2140","1730","8670","84500",130
"11735","5260","3320","2530","1910","3570","980","17570","52026",470
"11738","2600","1630","1150","930","1700","300","8310","48850",360
"11740","1370","660","500","420","1050","650","4650","64750",120
"11741","3950","2660","2090","1660","3410","710","14480","57536",560
"11742","1900","1260","950","840","1500","360","6810","56447",280
"11743","5900","3260","2460","2000","4640","3940","22200","69715",540
"11746","11270","6120","3920","2770","5900","3740","33720","47835",1090
"11747","2660","1440","1180","910","2450","2090","10730","77335",230
"11749","590","450","270","180","270","60","1820","42778",80
"11751","2200","1430","1070","750","1670","510","7630","54322",280
"11752","1590","1040","780","570","1160","180","5320","50962",190
"11753","1620","730","580","510","1370","1740","6550","91912",90
"11754","2630","1530","1250","980","2360","870","9620","63000",270
"11755","1720","1030","830","690","1470","460","6200","60542",200
"11756","6590","4400","3340","2630","5160","910","23030","53930",740
"11757","7640","5110","3520","2490","4220","630","23610","45377",1040
"11758","7850","4740","3780","3040","6700","2880","28990","62599",800
"11762","3020","1710","1430","1200","3220","1240","11820","70629",370
"11763","4810","3190","2010","1610","2570","470","14660","44749",620
"11764","1740","900","680","600","1670","760","6350","69669",180
"11765","70","30","40","30","60","100","330","95833",0
"11766","1620","870","640","630","1620","800","6180","73438",150
"11767","2010","1140","880","680","1820","760","7290","64062",210
"11768","2800","1390","1230","1010","2540","2130","11100","78218",240
"11769","1360","840","670","540","1270","390","5070","62500",150
"11771","1460","760","630","400","890","1050","5190","64881",110
"11772","7600","5070","3280","2380","3570","640","22540","43097",810
"11776","3980","2430","1590","1230","2480","510","12220","46914",480
"11777","1260","710","570","440","1070","690","4740","67544",110
"11778","1770","1110","870","720","1350","260","6080","54598",240
"11779","5780","3950","2940","2200","3920","640","19430","49905",720
"11780","2130","1140","890","680","1710","1240","7790","67556",160
"11782","2140","1280","1020","850","1960","850","8100","65441",240
"11783","2950","1710","1410","1190","2930","1040","11230","66933",320
"11784","4040","2730","1890","1350","2230","240","12480","45147",570
"11786","890","440","270","290","840","390","3120","71296",80
"11787","4500","2440","2040","1690","4460","2100","17230","70527",470
"11788","2320","1320","1120","940","2180","810","8690","65737",240
"11789","1050","710","600","460","790","120","3730","54375",160
"11790","1800","950","670","620","1750","960","6750","73321",160
"11791","3060","1370","1250","950","2710","2910","12250","86711",240
"11792","1100","650","490","420","1140","480","4280","69898",130
"11793","4320","2510","2030","1770","4460","1790","16880","69828",490
"11795","3620","2130","1640","1330","3170","1270","13160","62652",410
"11796","510","310","220","220","500","140","1900","64773",40
"11797","1180","550","410","340","780","1330","4590","86397",70
"11798","3710","2430","1000","510","680","110","8440","30247",310
"11801","7080","4480","3030","2230","4140","850","21810","46345",660
"11803","3430","1750","1630","1320","3710","2450","14290","81345",340
"11804","610","310","290","250","610","470","2540","81000",60
"11901","5360","3380","1610","1000","1350","300","13000","33432",490
"11933","1180","700","470","370","650","170","3540","46071",90
"11934","1200","690","460","400","950","300","4000","55978",150
"11935","520","310","250","200","350","200","1830","58500",60
"11937","3230","1870","1100","730","1250","920","9100","42647",360
"11939","160","100","80","50","100","50","540","53125",20
"11940","810","500","330","270","630","230","2770","55682",100
"11941","400","240","140","140","340","110","1370","58036",60
"11942","790","450","310","280","490","240","2560","53226",80
"11944","850","570","260","200","320","140","2340","39035",90
"11946","2800","1630","1030","690","1110","380","7640","40644",310
"11948","190","130","70","60","130","60","640","50000",0
"11949","2150","1210","870","720","1660","590","7200","56897",280
"11950","3020","1820","1090","730","930","80","7670","36195",430
"11951","2350","1530","950","620","710","60","6220","37418",390
"11952","840","470","310","280","510","220","2630","50403",70
"11953","2010","1500","1060","780","1120","170","6640","46833",240
"11954","980","670","350","200","330","200","2730","39366",310
"11955","510","370","310","190","310","60","1750","49662",70
"11957","120","70","50","40","100","60","440","65000",20
"11958","150","100","60","40","80","40","470","46250",0
"11961","2120","1420","1080","780","1180","170","6750","47095",210
"11963","1230","810","530","360","690","520","4140","51415",90
"11967","4550","2960","1910","1300","1940","180","12840","40794",730
"11968","1840","980","680","420","810","620","5350","46301",140
"11971","920","560","420","320","610","270","3100","54167",100
"11976","290","220","120","80","200","240","1150","63542",30
"11977","420","210","140","120","260","180","1330","56250",40
"11978","670","360","230","140","310","220","1930","45486",70
"11980","580","430","350","300","490","90","2240","57857",90
"12007","50","0","20","30","0","0","100","25000",0
"12008","60","40","40","30","80","0","250","65625",0
"12009","1050","710","550","430","790","230","3760","55455",100
"12010","5410","3430","1800","1090","1260","190","13180","33601",600
"12015","460","350","270","190","300","60","1630","50463",50
"12017","40","50","30","20","30","0","170","47500",0
"12018","1100","770","610","480","810","160","3930","53893",140
"12019","1930","1260","1160","1010","2010","540","7910","66487",180
"12020","4890","3560","2390","1810","3090","590","16330","47999",550
"12022","130","110","70","50","40","0","400","40909",30
"12023","310","230","180","110","180","0","1010","46196",50
"12025","950","700","400","310","360","50","2770","40536",150
"12027","560","320","260","260","540","130","2070","64904",40
"12028","190","140","110","70","80","0","590","43750",30
"12029","160","100","100","60","80","30","530","51250",0
"12031","40","30","30","0","0","0","100","33333",0
"12032","160","150","70","50","60","0","490","39167",20
"12033","1230","820","630","480","840","170","4170","51389",140
"12035","160","120","70","40","40","0","430","36458",0
"12037","670","450","280","170","200","60","1830","38611",50
"12041","80","50","50","30","60","0","270","52500",0
"12042","70","50","50","30","30","0","230","47500",0
"12043","1230","810","450","310","360","60","3220","36728",180
"12046","80","80","50","40","70","0","320","50000",0
"12047","3530","2850","1680","950","1220","290","10520","40175",410
"12051","610","420","250","190","250","40","1760","41071",80
"12052","190","180","130","110","130","0","740","50000",30
"12053","590","430","340","280","440","70","2150","54044",90
"12054","2110","1360","1230","1030","2290","850","8870","69614",140
"12056","330","240","180","150","240","50","1190","53472",40
"12057","280","210","130","70","90","0","780","38095",40
"12058","250","160","110","70","90","0","680","39062",30
"12059","220","180","150","110","170","0","830","52500",50
"12060","200","130","110","80","110","40","670","51136",20
"12061","1280","930","790","610","1110","300","5020","59494",120
"12062","250","220","160","100","140","0","870","46023",50
"12063","80","60","40","30","50","20","280","50000",0
"12064","80","60","40","30","0","0","210","35417",20
"12065","5920","4300","3330","2620","5030","1440","22640","58258",570
"12066","270","220","180","130","160","0","960","48864",60
"12067","220","150","140","110","140","20","780","53571",30
"12068","450","400","220","130","140","0","1340","38750",70
"12070","190","170","110","80","90","20","660","45588",30
"12071","50","30","20","20","0","0","120","33333",0
"12072","400","340","190","160","140","0","1230","40809",80
"12074","430","350","240","190","280","40","1530","48929",70
"12075","480","360","210","160","250","60","1520","44444",40
"12076","210","130","90","60","80","0","570","39423",50
"12077","850","530","440","350","780","300","3250","63920",60
"12078","4290","2760","1370","710","720","100","9950","31205",470
"12083","620","410","330","220","270","30","1880","44512",80
"12084","550","540","480","370","420","90","2450","57031",40
"12085","60","70","30","30","0","0","190","37500",0
"12086","270","240","170","120","140","0","940","45833",30
"12087","190","130","100","60","100","0","580","44231",30
"12090","1000","670","450","260","300","40","2720","38433",150
"12092","200","150","100","40","70","0","560","38333",40
"12093","260","160","110","60","80","0","670","36719",40
"12094","330","250","170","140","180","0","1070","45500",40
"12095","2050","1580","840","530","540","50","5590","36788",300
"12106","400","260","220","140","250","70","1340","51136",40
"12108","60","70","40","20","20","0","210","41071",0
"12110","2800","2220","1680","1230","1950","400","10280","51786",260
"12116","320","220","110","70","80","0","800","34091",40
"12117","570","450","200","150","150","20","1540","36111",100
"12118","2320","1720","1130","800","1420","300","7690","47166",310
"12120","90","60","40","40","50","0","280","45833",0
"12121","300","190","150","130","180","30","980","50000",40
"12122","720","520","310","170","190","0","1910","36298",120
"12123","750","620","450","310","410","80","2620","47581",110
"12125","260","200","110","60","60","30","720","37500",40
"12130","180","120","100","60","70","0","530","42708",0
"12131","40","30","0","30","0","0","100","33333",0
"12134","640","450","260","160","210","40","1760","38333",110
"12136","130","80","60","50","90","30","440","54167",0
"12137","260","210","150","120","140","0","880","46429",40
"12138","440","370","230","170","140","30","1380","41892",90
"12139","40","30","40","0","30","0","140","50000",0
"12140","230","190","150","120","200","30","920","56667",30
"12143","840","610","420","280","350","30","2530","42418",100
"12144","3210","2620","1860","1200","1470","210","10570","44800",380
"12147","70","60","40","50","50","0","270","53125",0
"12148","600","290","290","260","680","270","2390","76442",40
"12149","390","250","150","80","110","0","980","35000",70
"12150","140","100","80","60","70","0","450","46250",0
"12151","110","80","80","50","90","0","410","54688",0
"12153","110","90","80","70","110","0","460","59375",30
"12154","430","330","250","180","260","30","1480","48485",70
"12155","290","220","120","70","60","0","760","35227",40
"12156","100","100","80","60","80","0","420","53125",0
"12157","580","440","300","200","250","40","1810","43466",110
"12158","900","700","530","400","610","130","3270","51651",110
"12159","1120","630","520","390","1030","750","4440","72596",60
"12160","160","100","70","40","70","0","440","40000",30
"12164","110","70","40","30","30","0","280","35714",0
"12165","50","40","30","20","40","20","200","58333",0
"12166","230","190","110","50","70","0","650","37500",40
"12167","490","290","150","100","120","0","1150","32328",60
"12168","340","220","150","90","130","0","930","39205",60
"12169","60","60","0","20","30","0","170","35417",0
"12170","860","560","390","290","410","60","2570","43973",120
"12173","270","160","140","90","110","0","770","42969",40
"12175","120","80","60","40","40","0","340","40625",30
"12176","40","30","30","0","20","0","120","41667",0
"12180","8960","6230","3410","1990","2550","420","23560","36316",830
"12182","2730","1950","1030","670","700","60","7140","35769",350
"12183","470","490","220","110","90","0","1380","36224",60
"12184","970","690","470","360","610","160","3260","48913",80
"12185","330","230","150","90","170","20","990","42935",50
"12186","810","620","500","420","800","250","3400","63500",90
"12187","160","110","60","50","50","0","430","37500",30
"12188","1690","1510","950","670","990","170","5980","46523",230
"12189","3260","2750","1460","800","940","180","9390","38045",330
"12190","130","80","60","40","40","0","350","39062",0
"12192","290","170","110","80","110","0","760","38235",20
"12193","290","260","190","110","170","20","1040","47115",40
"12194","40","40","0","30","0","0","110","34375",0
"12196","450","310","230","190","340","80","1600","54348",50
"12197","340","260","140","100","110","0","950","37981",80
"12198","1190","860","660","460","790","170","4130","50568",120
"12202","2480","1320","390","130","110","0","4430","22329",160
"12203","4170","3410","2320","1460","2010","510","13880","45308",300
"12204","1160","1190","600","320","390","170","3830","40861",100
"12205","4500","3870","2690","1780","1980","190","15010","44412",400
"12206","3880","1930","630","280","280","50","7050","22713",230
"12207","420","200","70","30","40","0","760","22619",30
"12208","3270","2670","1620","960","1370","270","10160","41948",220
"12209","2040","1560","850","430","420","50","5350","35176",170
"12210","2250","1550","660","240","250","70","5020","29194",160
"12211","1530","950","820","680","1320","810","6110","67530",120
"12302","4020","3000","2270","1790","2790","420","14290","51377",380
"12303","5260","3530","2100","1420","2210","480","15000","40864",450
"12304","4280","2920","1490","800","820","80","10390","32834",340
"12305","920","600","250","110","90","0","1970","27708",70
"12306","4450","3610","2180","1400","1850","220","13710","41655",420
"12307","2050","730","150","40","20","0","2990","18232",100
"12308","2780","1770","810","420","430","70","6280","30085",220
"12309","3670","2470","2150","1800","3730","1290","15110","66453",320
"12401","6670","4080","2230","1390","1680","340","16390","34344",510
"12404","600","360","240","150","230","50","1630","39931",80
"12405","120","80","40","40","30","0","310","35938",0
"12406","150","80","50","0","30","0","310","26562",0
"12407","50","30","40","0","0","0","120","33333",0
"12409","190","80","50","50","60","50","480","40625",0
"12410","60","40","50","0","30","0","180","43750",0
"12411","90","60","40","40","30","0","260","41667",0
"12412","140","70","50","30","50","0","340","35714",0
"12413","550","380","200","110","140","0","1380","34211",60
"12414","1820","1190","700","390","480","90","4670","35819",190
"12418","100","60","40","30","30","0","260","37500",20
"12419","100","70","50","40","70","0","330","48214",0
"12421","50","40","20","20","20","0","150","40625",0
"12422","50","30","30","30","0","0","140","41667",0
"12423","190","110","70","40","60","0","470","35227",20
"12427","110","50","30","20","0","0","210","23864",0
"12428","1210","620","330","220","220","30","2630","29234",120
"12430","180","100","60","40","50","0","430","33750",0
"12431","260","170","120","80","100","0","730","40441",40
"12433","70","40","30","30","40","0","210","46875",0
"12434","160","80","50","20","20","0","330","26562",30
"12435","60","50","30","20","30","0","190","42500",0
"12439","90","30","40","0","30","0","190","29167",0
"12440","330","240","150","90","150","40","1000","42708",40
"12442","200","110","60","40","50","20","480","34091",20
"12443","560","390","330","260","410","90","2040","55303",60
"12444","60","40","30","0","30","0","160","37500",0
"12446","840","510","340","220","270","30","2210","37990",110
"12448","40","50","0","0","20","0","110","32500",0
"12449","620","410","250","180","190","20","1670","38110",60
"12451","280","210","130","80","110","0","810","39881",30
"12454","50","40","0","30","0","0","120","31250",0
"12455","300","190","110","70","80","0","750","34868",30
"12456","150","110","70","40","20","0","390","35227",0
"12457","120","60","60","0","50","0","290","35417",0
"12458","420","300","160","90","110","0","1080","35000",50
"12460","60","30","30","0","20","0","140","33333",0
"12461","270","180","100","90","100","30","770","40972",20
"12463","260","180","110","100","90","20","760","41667",30
"12464","180","90","70","40","50","0","430","34722",0
"12465","60","20","30","0","0","0","110","22917",0
"12466","510","410","270","170","230","30","1620","43293",40
"12468","230","120","60","50","50","0","510","30208",40
"12469","100","60","60","30","50","0","300","45833",0
"12470","80","60","30","20","30","0","220","37500",0
"12472","290","210","140","100","120","0","860","41667",20
"12473","160","100","70","40","60","0","430","38750",0
"12474","210","120","90","50","70","0","540","37500",30
"12477","3260","2110","1250","890","1140","210","8860","38863",320
"12480","110","60","60","0","30","0","260","33333",0
"12481","250","150","90","70","90","20","670","39167",30
"12482","140","100","50","20","20","0","330","31250",0
"12484","440","290","200","170","250","90","1440","49138",40
"12485","200","110","80","30","60","0","480","34091",30
"12486","210","150","120","110","150","0","740","52083",20
"12487","510","330","200","170","210","30","1450","41288",40
"12491","360","210","140","110","150","30","1000","41667",50
"12492","40","40","0","40","0","0","120","37500",0
"12494","110","90","60","30","50","0","340","41667",0
"12495","40","40","0","20","40","0","140","43750",0
"12496","290","150","90","60","80","20","690","34167",40
"12498","800","390","320","230","410","190","2340","48718",40
"12501","360","260","160","100","140","30","1050","40865",30
"12502","130","110","90","50","60","20","460","47727",0
"12503","100","60","30","30","60","0","280","41667",0
"12508","2830","2040","1350","930","1310","220","8680","43505",270
"12513","160","130","110","70","110","30","610","53409",0
"12514","370","210","190","160","320","100","1350","62500",30
"12515","310","180","110","90","100","20","810","38194",30
"12516","250","180","110","80","90","20","730","40972",0
"12517","80","50","40","0","40","0","210","37500",0
"12518","920","530","400","320","590","240","3000","53125",100
"12520","430","290","230","180","420","140","1690","63587",40
"12521","250","180","130","60","110","30","760","43056",30
"12522","760","570","340","230","280","50","2230","40570",100
"12523","300","220","150","100","110","0","880","40909",40
"12524","2140","1480","1230","950","1700","430","7930","57012",230
"12525","540","370","300","210","300","90","1810","49662",70
"12526","620","420","270","190","250","80","1830","42560",60
"12528","2110","1420","1000","780","1160","220","6690","46743",240
"12529","420","270","150","100","150","60","1150","39352",50
"12531","430","290","200","180","350","120","1570","58125",60
"12533","3450","1970","1490","1370","3010","1240","12530","64178",380
"12534","3150","2080","1050","620","670","160","7730","33594",240
"12538","2130","1470","950","770","1120","160","6600","44898",230
"12540","1090","540","430","370","910","390","3730","63663",110
"12542","900","670","420","330","530","120","2970","46828",130
"12543","470","410","270","170","200","0","1520","42683",50
"12545","660","450","290","230","370","190","2190","49167",60
"12546","520","350","200","120","150","50","1390","37500",60
"12547","460","300","240","160","250","70","1480","48333",60
"12548","260","160","130","90","160","0","800","46875",50
"12549","1530","920","690","550","1090","260","5040","52536",170
"12550","10640","5960","2990","2100","3070","670","25430","33704",870
"12553","4040","2890","1900","1260","2260","430","12780","45329",460
"12561","2480","1410","950","750","1300","400","7290","45656",230
"12563","1170","600","480","350","700","240","3540","50000",120
"12564","970","670","450","350","740","250","3430","54167",90
"12565","330","220","110","60","60","0","780","31818",30
"12566","1610","1060","720","630","900","130","5050","46580",230
"12567","410","330","210","130","160","60","1300","43182",40
"12569","1570","1050","700","560","1000","280","5160","49048",180
"12570","920","560","400","370","940","260","3450","65312",110
"12571","1440","910","640","480","860","260","4590","48489",120
"12572","1240","850","630","480","840","390","4430","54960",90
"12575","320","180","130","130","290","90","1140","63462",40
"12577","310","180","120","130","240","70","1050","57292",40
"12578","320","210","160","120","240","70","1120","54688",40
"12580","570","330","240","240","350","120","1850","52604",50
"12581","290","220","160","110","160","60","1000","48864",30
"12582","600","370","280","280","580","180","2290","65625",70
"12583","400","260","140","120","150","40","1110","39904",30
"12585","130","80","50","50","100","30","440","55000",0
"12586","2080","1380","880","620","1070","150","6180","43297",260
"12589","2280","1280","960","680","1180","210","6590","44824",270
"12590","5460","3620","2710","2120","3560","770","18240","50369",550
"12592","170","170","90","70","80","0","580","42647",0
"12594","660","420","300","210","310","50","1950","43750",90
"12601","7710","4510","2240","1290","1760","330","17840","31707",520
"12603","6340","4250","3030","2300","4210","1020","21150","49912",580
"12701","2230","1210","510","280","280","70","4580","26240",170
"12719","150","90","70","50","70","0","430","43056",0
"12720","60","0","30","0","20","0","110","22917",0
"12721","970","660","440","320","490","70","2950","44129",140
"12723","260","180","90","60","90","20","700","37500",30
"12725","50","40","30","0","30","0","150","40625",0
"12726","170","100","70","60","80","0","480","42500",20
"12729","320","220","130","70","90","0","830","35795",40
"12732","140","70","50","40","70","0","370","41071",20
"12733","120","70","30","20","0","0","240","25000",0
"12734","200","180","80","40","50","0","550","35417",0
"12737","300","170","110","110","120","20","830","41912",40
"12738","40","40","0","30","0","0","110","34375",0
"12740","310","190","150","120","120","20","910","44079",30
"12741","60","30","20","30","0","0","140","33333",0
"12742","60","50","20","20","0","0","150","32500",0
"12743","50","40","30","0","20","0","140","37500",0
"12746","220","130","100","50","70","0","570","37500",30
"12747","330","200","100","70","90","0","790","33125",30
"12748","330","220","140","90","150","0","930","40341",30
"12751","200","110","50","30","20","0","410","26136",0
"12752","40","40","20","30","0","0","130","40625",0
"12754","1250","750","330","190","250","50","2820","30333",80
"12758","680","420","220","150","200","20","1690","34821",80
"12759","380","170","70","40","40","0","700","23026",30
"12760","90","50","30","40","0","0","210","32500",0
"12762","100","70","30","20","40","0","260","35714",0
"12763","120","90","60","30","40","0","340","38889",0
"12764","290","160","90","70","110","0","720","35938",30
"12765","140","100","70","60","80","0","450","46250",0
"12766","90","30","20","20","0","0","160","22222",0
"12768","170","110","60","50","50","0","440","36364",20
"12771","2640","1420","820","560","760","100","6300","33979",260
"12775","360","250","170","160","240","80","1260","52941",30
"12776","310","200","130","70","110","0","820","37500",20
"12777","90","60","50","50","60","20","330","57500",0
"12779","490","310","110","60","80","0","1050","27823",30
"12780","420","230","160","140","180","0","1130","40761",40
"12783","220","160","90","50","80","0","600","37500",20
"12786","110","70","50","30","60","0","320","42857",0
"12787","70","60","40","30","30","0","230","43750",0
"12788","360","250","130","90","120","0","950","36500",30
"12789","310","200","110","40","90","0","750","33125",30
"12790","770","570","360","230","260","40","2230","40132",90
"12791","110","70","40","40","50","0","310","41071",0
"12792","80","40","30","30","20","0","200","37500",0
"12801","3200","2050","1030","610","610","100","7600","32317",320
"12803","1640","1140","610","430","460","30","4310","36294",160
"12804","4920","2860","1940","1410","2170","540","13840","42483",480
"12808","50","30","30","30","30","0","170","54167",0
"12809","550","440","240","180","200","0","1610","39489",70
"12810","140","90","40","20","20","0","310","29167",30
"12812","40","30","0","30","0","0","100","33333",0
"12814","400","210","100","80","120","50","960","34524",90
"12815","150","140","80","50","70","0","490","41964",30
"12816","740","520","340","210","230","40","2080","39423",100
"12817","400","280","170","110","130","30","1120","39286",90
"12819","60","50","0","20","0","0","130","27500",0
"12821","50","40","30","20","0","0","140","37500",0
"12822","1040","780","420","300","270","0","2810","36699",160
"12823","40","30","40","0","20","0","130","45833",0
"12824","150","90","60","40","70","20","430","43056",30
"12827","670","480","320","210","190","30","1900","39583",110
"12828","1780","1290","750","420","480","40","4760","36628",250
"12831","2700","1660","1180","960","1710","370","8580","48946",280
"12832","1120","700","450","250","240","20","2780","34643",170
"12833","710","520","310","220","380","130","2270","45433",90
"12834","1130","750","470","360","440","70","3220","41000",150
"12835","470","300","220","150","140","0","1280","39167",70
"12836","100","90","30","20","50","0","290","37500",30
"12837","140","110","50","30","30","0","360","34091",20
"12838","110","80","50","30","40","0","310","39062",20
"12839","2570","1780","940","560","420","40","6310","33216",340
"12842","220","160","100","70","60","0","610","38281",60
"12843","100","70","70","0","30","0","270","37500",0
"12844","30","30","30","0","50","0","140","58333",0
"12845","1060","540","330","230","350","120","2630","36806",150
"12846","590","410","260","160","170","0","1590","37500",110
"12847","130","100","60","30","40","0","360","37500",20
"12849","120","70","30","40","40","0","300","35714",0
"12850","390","330","220","160","220","60","1380","47727",60
"12851","70","40","20","20","0","0","150","28125",20
"12852","60","40","40","20","30","0","190","46875",20
"12853","280","150","90","60","60","0","640","31667",50
"12855","40","40","20","20","0","0","120","37500",0
"12857","120","70","40","30","30","0","290","33929",0
"12859","310","230","160","110","180","0","990","45109",50
"12860","150","120","40","30","30","0","370","32292",20
"12861","100","60","40","30","60","0","290","43750",20
"12863","110","90","50","40","70","0","360","44444",0
"12865","610","400","250","150","140","30","1580","36250",60
"12866","5630","3980","2640","2060","3620","1700","19630","51941",500
"12870","300","220","120","70","60","20","790","35795",20
"12871","690","470","300","230","260","40","1990","41223",70
"12873","120","80","70","30","50","0","350","42188",0
"12878","140","90","40","40","0","0","310","29167",0
"12883","930","540","350","200","230","30","2280","34722",160
"12885","970","570","290","180","170","20","2200","30702",190
"12886","50","40","0","30","0","0","120","31250",0
"12887","870","600","340","210","180","0","2200","34583",150
"12901","5850","3670","1970","1240","1400","300","14430","34298",660
"12903","210","200","170","100","140","0","820","50000",40
"12910","270","210","110","80","60","0","730","36310",60
"12912","380","280","150","90","80","0","980","34821",70
"12913","200","140","70","80","60","0","550","38393",20
"12914","140","90","50","30","20","0","330","31944",0
"12916","380","240","150","90","50","0","910","32812",70
"12917","220","160","100","70","50","0","600","37500",30
"12918","370","300","180","130","160","0","1140","41667",50
"12919","610","360","240","150","180","0","1540","36111",80
"12920","340","260","180","100","130","0","1010","40865",40
"12921","440","290","180","140","160","30","1240","40517",60
"12923","90","60","30","20","20","0","220","33333",0
"12926","370","270","120","70","60","0","890","31944",60
"12928","330","240","140","90","110","0","910","38021",70
"12930","120","70","50","40","0","0","280","32143",0
"12932","240","170","100","70","70","0","650","37500",30
"12934","140","110","70","50","30","0","400","38636",0
"12935","220","180","110","70","80","0","660","40278",30
"12936","130","80","40","40","50","0","340","37500",0
"12937","270","140","80","40","60","0","590","29464",30
"12941","240","180","100","70","70","0","660","37500",40
"12942","100","80","50","40","60","0","330","45312",0
"12943","80","50","30","30","30","0","220","40000",0
"12944","750","490","260","170","140","20","1830","33418",140
"12945","110","80","60","40","40","0","330","42188",0
"12946","1030","720","380","210","290","120","2750","36979",80
"12950","140","80","50","40","30","0","340","34375",20
"12952","90","80","40","20","20","0","250","35938",0
"12953","2000","1130","700","430","450","80","4790","33739",260
"12955","70","40","30","30","0","0","170","34375",0
"12956","190","140","80","50","30","0","490","34821",40
"12957","330","200","110","50","30","0","720","28750",70
"12958","300","220","110","110","90","0","830","38068",50
"12959","230","170","100","60","60","0","620","36765",40
"12960","170","130","80","40","60","0","480","38462",40
"12961","40","30","20","20","0","0","110","37500",0
"12962","800","620","420","300","430","50","2620","45565",110
"12965","100","60","30","30","0","0","220","29167",30
"12966","490","320","210","100","90","0","1210","33984",70
"12967","180","130","70","40","40","0","460","34615",30
"12969","70","50","30","30","0","0","180","35000",0
"12970","50","50","20","30","0","0","150","37500",0
"12972","940","660","490","330","510","70","3000","46212",150
"12974","260","180","100","60","60","0","660","34722",50
"12978","80","40","30","40","0","0","190","34375",20
"12979","440","300","180","130","160","0","1210","38750",60
"12980","220","140","90","50","40","0","540","33929",50
"12981","360","280","180","130","150","0","1100","41964",80
"12983","1360","890","520","310","420","90","3590","37219",130
"12985","180","130","70","50","40","0","470","35577",30
"12986","850","740","510","250","250","30","2630","40709",90
"12987","50","30","20","30","0","0","130","37500",0
"12989","130","110","80","60","60","0","440","45455",30
"12992","830","650","350","220","250","0","2300","37308",130
"12993","260","180","130","70","120","0","760","41667",30
"12996","360","250","130","90","90","0","920","35000",50
"12997","230","140","70","50","80","0","570","34821",30
"12998","100","60","30","30","0","0","220","29167",20
"13021","7420","4440","2750","1610","1960","350","18530","35389",870
"13026","190","150","120","70","110","0","640","46667",30
"13027","5020","3550","2480","1820","3070","780","16720","48521",510
"13028","210","140","110","60","60","0","580","39286",50
"13029","1120","750","510","430","600","120","3530","46500",150
"13030","690","550","330","170","240","40","2020","39545",100
"13031","2510","1830","1330","910","1490","350","8420","48224",230
"13032","2270","1540","890","540","580","80","5900","36039",360
"13033","600","440","300","190","200","0","1730","40057",90
"13034","300","210","130","100","140","0","880","41667",40
"13035","1200","660","490","440","700","370","3860","53571",100
"13036","1520","1120","650","450","460","50","4250","38504",260
"13037","1440","1000","640","440","660","120","4300","42750",170
"13039","2700","1680","1280","1030","1760","340","8790","50293",290
"13040","460","320","190","100","110","0","1180","35156",150
"13041","1600","1200","910","740","1010","130","5590","49896",210
"13042","340","270","180","110","110","0","1010","40278",70
"13044","410","320","200","120","180","0","1230","41016",80
"13045","4540","2900","1660","990","1230","210","11530","35560",530
"13052","270","240","120","100","100","0","830","40104",70
"13053","760","510","330","220","330","60","2210","41912",80
"13054","250","190","130","80","60","0","710","38816",50
"13057","2700","2070","1230","760","950","140","7850","39795",310
"13060","500","350","200","130","180","30","1390","38929",50
"13061","140","120","90","60","80","0","490","46875",30
"13063","290","180","120","90","190","30","900","47222",40
"13066","1740","1020","840","680","1350","880","6510","64732",130
"13068","840","640","420","270","300","50","2520","41406",110
"13069","4310","2820","1530","920","960","100","10640","33954",760
"13071","180","110","80","40","50","0","460","36364",0
"13072","160","120","50","30","20","0","380","31250",30
"13073","1070","800","490","300","360","40","3060","39375",130
"13074","770","500","310","170","180","0","1930","34750",170
"13076","390","280","160","120","150","0","1100","39286",60
"13077","1140","830","500","310","380","70","3230","39307",190
"13078","1270","700","560","430","920","640","4520","62946",100
"13080","600","420","300","170","220","20","1730","40774",100
"13081","140","120","90","60","90","0","500","47917",0
"13082","820","620","320","250","280","20","2310","38508",110
"13083","300","180","140","80","90","0","790","38194",70
"13084","670","490","350","250","330","90","2180","46429",100
"13088","3890","3440","2100","1160","1270","170","12030","40443",390
"13090","4990","3620","2470","1740","2570","380","15770","44993",510
"13092","410","310","160","120","130","0","1130","37500",60
"13101","460","320","180","120","100","0","1180","35156",110
"13103","90","40","30","0","0","0","160","22222",0
"13104","2260","1160","870","700","1630","1170","7790","63649",170
"13108","960","610","440","360","630","120","3120","49590",100
"13110","330","260","190","140","170","40","1130","47596",40
"13111","310","190","130","60","40","0","730","32237",60
"13112","320","210","130","90","160","20","930","42262",40
"13114","1050","740","410","300","400","40","2940","39189",210
"13116","580","430","270","220","260","30","1790","43314",60
"13118","830","630","400","260","250","30","2400","39683",160
"13120","420","320","180","90","70","0","1080","34375",70
"13122","180","130","80","50","90","0","530","41346",0
"13126","5470","3230","2100","1420","1910","290","14420","38467",940
"13131","620","490","250","160","200","0","1720","37245",120
"13132","690","470","270","200","240","30","1900","38830",110
"13135","1190","720","460","290","400","60","3120","37847",180
"13136","90","60","30","20","0","0","200","29167",0
"13140","820","520","310","180","160","0","1990","33413",150
"13141","130","100","50","30","40","0","350","36250",30
"13142","1090","690","420","260","330","40","2830","36775",200
"13143","440","290","170","120","110","0","1130","35776",90
"13144","210","150","70","50","50","0","530","34167",50
"13145","320","230","130","90","100","0","870","37500",70
"13146","340","250","180","80","60","0","910","36500",50
"13147","150","150","70","60","60","0","490","40833",20
"13148","2000","1170","720","440","550","80","4960","35256",220
"13152","1210","660","510","410","770","510","4070","58088",110
"13155","100","100","40","20","30","0","290","36250",20
"13156","280","170","140","90","120","0","800","42647",60
"13158","270","190","80","70","50","0","660","32895",50
"13159","800","550","360","260","490","120","2580","47273",110
"13160","330","250","140","100","130","0","950","39500",40
"13164","380","260","170","160","260","30","1260","49038",40
"13165","2070","1370","750","440","410","40","5080","33577",260
"13166","880","720","440","270","260","20","2590","39410",150
"13167","550","450","210","150","200","30","1590","38611",100
"13202","1000","370","190","90","90","50","1790","22375",40
"13203","3310","1750","590","280","310","120","6360","24018",170
"13204","4500","2220","730","280","200","40","7970","22139",300
"13205","4010","1990","770","330","240","30","7370","22974",270
"13206","3630","2690","1120","550","430","40","8460","30576",360
"13207","2670","1670","800","450","390","60","6040","30240",250
"13208","5250","2620","920","400","260","0","9450","22500",370
"13209","2610","1880","1050","600","570","70","6780","35372",250
"13210","3250","1440","660","370","470","100","6290","24192",180
"13211","1390","1100","490","220","110","0","3310","31023",160
"13212","3770","2970","1730","1060","1020","110","10660","38131",390
"13214","1250","720","560","410","690","150","3780","47222",70
"13215","2180","1190","930","750","1600","510","7160","55645",200
"13219","2620","2000","1430","910","1200","140","8300","44125",250
"13224","1670","910","490","350","580","240","4240","37363",110
"13302","310","170","90","60","40","0","670","28676",60
"13303","180","130","90","70","80","0","550","43269",30
"13304","280","200","130","90","170","40","910","46875",30
"13308","580","420","260","130","140","0","1530","36012",90
"13309","1020","700","410","260","230","30","2650","35893",220
"13310","100","90","50","30","20","0","290","37500",20
"13314","90","50","30","30","0","0","200","30000",0
"13315","260","170","90","60","60","0","640","33824",40
"13316","1080","810","440","260","250","30","2870","35957",200
"13317","650","430","290","150","170","0","1690","36337",120
"13318","230","200","90","60","60","0","640","36250",50
"13319","170","150","60","30","40","0","450","34167",20
"13320","350","260","130","80","90","0","910","35096",50
"13322","200","140","100","50","70","0","560","39286",30
"13323","1530","990","740","510","770","250","4790","46843",130
"13324","310","250","170","80","80","0","890","38500",80
"13325","180","120","70","30","40","0","440","33333",40
"13326","890","530","370","230","360","210","2590","44104",100
"13327","360","290","180","90","70","0","990","36638",120
"13328","200","150","80","50","80","0","560","38333",30
"13329","650","440","270","150","100","0","1610","33807",140
"13331","50","30","30","0","20","0","130","37500",0
"13332","430","320","160","90","100","0","1100","34375",60
"13334","190","140","100","50","50","0","530","38393",40
"13335","270","200","90","70","70","0","700","35000",30
"13337","160","90","60","40","50","30","430","40278",0
"13338","220","160","110","50","50","0","590","36719",40
"13339","1110","730","360","200","200","0","2600","31507",170
"13340","1410","1000","530","370","360","40","3710","36125",200
"13343","270","210","120","80","80","0","760","38095",80
"13346","590","400","270","210","340","130","1940","48750",70
"13348","220","170","110","60","80","0","640","39706",0
"13350","1690","1030","550","300","330","30","3930","31675",220
"13354","550","360","270","180","220","20","1600","42361",50
"13355","160","110","60","30","40","0","400","34091",30
"13357","1840","1330","750","410","380","30","4740","34962",300
"13360","100","40","40","0","30","0","210","28125",20
"13361","120","80","40","50","0","0","290","32812",0
"13363","390","280","170","110","150","0","1100","39286",70
"13365","1520","940","540","320","330","30","3680","33511",210
"13367","1340","960","580","330","360","60","3630","37370",290
"13368","230","150","70","40","50","0","540","31667",60
"13402","260","200","80","50","70","0","660","33750",40
"13403","890","490","380","260","400","70","2490","43112",70
"13406","100","80","40","30","30","0","280","37500",20
"13407","920","690","410","220","190","0","2430","35688",120
"13408","400","300","160","120","120","0","1100","37500",70
"13409","420","290","180","120","90","0","1100","36207",70
"13411","540","380","190","100","110","0","1320","32895",70
"13413","2310","1510","1170","850","1370","570","7780","51496",200
"13416","310","260","160","110","130","0","970","41827",100
"13417","670","550","240","150","140","0","1750","34318",60
"13420","300","190","130","90","80","30","820","39474",50
"13421","2600","1670","870","490","610","120","6360","33683",270
"13424","350","290","180","100","160","0","1080","41379",30
"13425","360","240","160","70","80","0","910","34896",80
"13428","230","170","110","50","60","0","620","36765",40
"13431","300","210","150","100","150","0","910","43452",50
"13433","340","180","110","60","40","0","730","28472",80
"13437","70","50","40","30","0","0","190","37500",0
"13438","520","460","290","180","200","30","1680","42391",90
"13439","670","490","260","150","130","20","1720","34694",160
"13440","7020","4820","2720","1670","1760","230","18220","35840",730
"13450","60","20","20","30","0","0","130","31250",0
"13452","780","540","290","160","130","0","1900","32870",160
"13454","130","90","60","40","30","0","350","37500",50
"13456","690","450","300","220","300","50","2010","42500",90
"13459","350","240","170","90","80","0","930","36979",70
"13460","830","580","320","170","180","20","2100","34483",100
"13461","530","360","260","220","230","30","1630","44792",50
"13464","210","150","80","30","20","0","490","30833",0
"13468","90","60","40","20","30","0","240","37500",0
"13469","110","100","50","50","70","0","380","45000",0
"13470","110","90","50","40","0","0","290","34722",30
"13471","600","380","210","100","110","0","1400","31579",100
"13473","110","110","50","40","30","0","340","38636",30
"13476","610","430","240","150","170","20","1620","36628",80
"13477","250","150","100","50","70","0","620","35000",40
"13478","460","400","250","170","160","0","1440","41250",70
"13480","540","440","230","160","180","0","1550","38352",110
"13483","50","50","0","20","0","0","120","30000",0
"13485","190","110","80","30","30","0","440","31818",30
"13486","140","90","70","40","50","0","390","40278",0
"13488","60","30","50","0","0","0","140","33333",0
"13489","100","80","50","30","20","0","280","37500",30
"13490","230","180","110","90","80","0","690","40972",30
"13491","600","470","260","160","190","0","1680","37766",140
"13492","1910","1420","920","660","930","180","6020","44366",160
"13493","330","260","120","80","50","0","840","33654",70
"13494","70","40","40","0","0","0","150","28125",0
"13495","410","310","190","100","70","0","1080","35484",30
"13501","7960","3840","1420","710","900","180","15010","23571",510
"13502","6330","3770","1880","1010","980","110","14080","29708",520
"13601","7030","4370","2190","1200","1350","300","16440","31808",740
"13603","1120","1790","550","200","100","0","3760","35615",60
"13605","750","470","280","200","250","30","1980","37766",100
"13606","440","280","200","130","170","0","1220","40179",60
"13607","430","240","150","100","90","20","1030","33854",160
"13608","220","160","110","60","60","0","610","38281",90
"13612","440","330","210","130","140","0","1250","39015",60
"13613","420","250","150","100","100","0","1020","34000",60
"13614","60","30","30","0","0","0","120","25000",0
"13616","270","270","110","40","30","0","720","33333",30
"13617","1260","920","600","410","520","90","3800","42391",160
"13618","310","190","140","90","120","0","850","40132",50
"13619","1610","1210","680","350","380","50","4280","35950",240
"13620","320","240","140","90","70","0","860","36458",70
"13621","120","60","40","30","30","0","280","33333",30
"13622","380","250","160","110","140","0","1040","39000",50
"13624","820","490","330","220","290","50","2200","39286",230
"13625","300","220","150","100","130","0","900","42045",70
"13626","340","250","170","90","100","0","950","38500",70
"13630","200","140","90","50","30","0","510","34821",20
"13634","650","430","290","210","250","0","1830","40407",100
"13635","170","100","70","40","30","0","410","33750",40
"13636","60","50","40","0","0","0","150","32500",0
"13637","710","700","290","150","120","0","1970","34821",90
"13638","70","60","50","0","0","0","180","33333",0
"13640","60","40","30","30","60","0","220","58333",0
"13642","1360","850","520","310","280","50","3370","34559",340
"13646","400","210","130","80","70","0","890","30357",120
"13648","330","280","160","110","90","0","970","38839",110
"13650","250","140","70","60","80","0","600","33929",30
"13652","310","220","120","60","50","0","760","32955",60
"13654","300","230","140","80","80","0","830","37500",40
"13655","750","440","160","80","70","0","1500","25000",110
"13656","420","310","180","110","100","0","1120","36290",120
"13658","350","300","160","100","110","0","1020","38333",60
"13659","90","60","70","0","30","0","250","39583",30
"13660","320","210","150","70","90","0","840","36905",60
"13661","230","190","120","60","80","0","680","39474",30
"13662","2960","1730","1010","620","650","90","7060","33237",360
"13664","70","50","40","30","40","0","230","47500",0
"13665","160","100","60","40","20","0","380","32500",40
"13667","570","350","200","120","120","0","1360","32857",90
"13668","560","380","240","140","160","0","1480","36842",90
"13669","2420","1600","930","540","690","90","6270","36172",350
"13670","70","40","40","0","0","0","150","28125",0
"13672","110","90","60","30","30","0","320","38889",30
"13673","360","250","160","100","80","0","950","36500",90
"13676","1890","1080","700","480","640","130","4920","38194",280
"13679","360","200","120","90","90","0","860","33750",140
"13680","160","120","60","40","40","0","420","35417",40
"13681","140","90","60","50","0","0","340","33333",50
"13682","130","110","70","50","60","0","420","43182",20
"13684","170","150","80","40","40","0","480","36667",30
"13685","330","290","200","130","170","40","1160","46552",40
"13687","90","70","40","30","40","0","270","41071",0
"13690","130","90","50","40","30","0","340","36111",20
"13691","530","310","210","130","140","0","1320","35484",130
"13693","80","70","50","20","40","0","260","42857",0
"13694","250","170","110","80","120","0","730","41912",40
"13696","40","40","0","20","0","0","100","31250",0
"13697","360","270","130","90","80","0","930","34722",70
"13730","500","320","200","130","110","0","1260","35156",80
"13731","190","110","70","50","70","0","490","37500",0
"13732","1230","770","560","460","690","110","3820","47078",170
"13733","840","570","360","220","240","0","2230","37061",130
"13734","400","250","150","80","90","0","970","33500",70
"13736","390","270","170","100","110","0","1040","37037",70
"13739","160","110","70","40","40","0","420","36364",20
"13740","90","40","30","30","40","0","230","40625",0
"13743","610","450","250","180","200","0","1690","38056",90
"13744","210","140","80","70","60","0","560","37500",50
"13746","450","300","210","120","170","0","1250","39583",70
"13748","690","410","310","180","180","20","1790","37500",90
"13750","200","130","70","30","30","0","460","30769",30
"13751","50","40","30","0","0","0","120","31250",0
"13752","120","80","60","30","30","0","320","37500",0
"13753","720","480","260","180","210","30","1880","36458",80
"13754","610","300","190","140","110","0","1350","30417",110
"13755","230","170","80","60","50","0","590","34559",30
"13756","90","50","40","0","20","0","200","30000",0
"13757","160","120","70","50","50","0","450","38542",0
"13760","8140","4990","3060","1910","2730","480","21310","37600",890
"13775","270","220","100","80","90","0","760","37500",30
"13776","130","80","50","30","40","0","330","35938",0
"13777","140","90","50","40","40","0","360","36111",40
"13778","980","750","400","290","260","40","2720","37667",160
"13780","150","130","80","40","60","0","460","40385",0
"13782","140","80","50","30","30","0","330","32812",0
"13783","430","240","160","100","90","0","1020","33333",80
"13786","60","50","30","30","0","0","170","37500",0
"13787","630","430","230","130","120","0","1540","33140",120
"13788","140","130","70","30","50","0","420","38462",20
"13790","3810","2310","1220","630","610","90","8670","30682",370
"13795","690","470","260","160","190","0","1770","35372",90
"13796","230","150","80","60","60","0","580","35000",30
"13797","350","250","140","70","80","0","890","34500",70
"13801","210","160","70","30","40","0","510","32031",40
"13802","160","100","60","50","40","0","410","36250",20
"13803","730","500","280","180","170","0","1860","35000",140
"13804","80","70","50","0","20","0","220","35714",0
"13807","240","140","100","50","80","0","610","36607",20
"13808","300","190","120","80","80","0","770","36184",50
"13809","280","200","110","60","60","0","710","34375",40
"13810","220","140","110","50","40","0","560","35714",30
"13811","740","530","310","180","200","20","1980","36792",100
"13812","430","260","180","100","90","0","1060","34615",70
"13813","180","80","70","40","30","0","400","31250",20
"13815","2470","1550","870","500","550","110","6050","33952",240
"13820","3180","1950","1100","700","900","150","7980","35385",300
"13825","600","410","250","140","160","0","1560","35976",100
"13827","2030","1230","780","510","650","100","5300","37602",260
"13830","830","550","360","200","190","20","2150","36136",100
"13832","110","80","30","40","0","0","260","31250",0
"13833","750","510","310","170","180","20","1940","35784",140
"13835","260","190","120","60","50","0","680","35526",50
"13838","810","520","280","160","170","20","1960","33173",110
"13839","230","170","100","50","50","0","600","35294",50
"13841","100","60","40","30","0","0","230","31250",30
"13842","70","40","40","30","30","0","210","46875",0
"13843","290","220","110","80","60","0","760","35227",40
"13844","150","90","50","30","20","0","340","30556",0
"13846","60","40","20","30","0","0","150","34375",0
"13849","780","530","330","190","200","0","2030","36085",130
"13850","3140","1890","1430","1140","1720","580","9900","48942",290
"13856","1140","700","390","230","200","30","2690","32321",140
"13861","120","80","60","40","40","0","340","40625",20
"13862","720","480","280","170","200","0","1850","35677",130
"13863","90","40","30","20","0","0","180","25000",30
"13864","200","150","90","40","40","0","520","35000",30
"13865","1090","690","460","280","270","20","2810","36413",180
"13901","3710","1980","1180","700","980","150","8700","33081",360
"13903","3570","2070","1150","680","860","270","8600","33816",430
"13904","1790","1060","600","310","340","40","4140","31604",220
"13905","5060","2550","1400","800","960","230","11000","29314",420
"14001","1620","1210","770","510","640","90","4840","41529",270
"14004","1760","1210","830","690","820","80","5390","44318",300
"14005","340","210","180","100","100","0","930","39881",40
"14006","1750","1210","770","490","520","60","4800","38430",300
"14008","260","190","120","60","80","0","710","37500",60
"14009","950","740","400","230","250","40","2610","36993",220
"14011","960","730","520","350","330","30","2920","42123",180
"14012","400","290","190","110","110","0","1100","37931",80
"14013","290","190","120","60","70","0","730","34868",50
"14020","4250","2610","1400","880","960","120","10220","33238",470
"14024","260","200","140","80","70","0","750","39375",70
"14025","460","360","250","190","270","50","1580","47917",80
"14026","140","90","50","40","60","0","380","38889",0
"14028","260","170","120","80","110","0","740","41176",50
"14030","260","200","120","80","70","0","730","38125",50
"14031","1580","920","640","490","820","500","4950","49321",160
"14032","1290","570","430","440","940","580","4250","65407",130
"14033","330","260","190","140","220","60","1200","51316",80
"14034","310","220","150","100","90","0","870","39205",70
"14036","810","620","390","270","300","50","2440","41532",150
"14037","210","130","90","60","100","0","590","41346",60
"14040","390","240","190","130","160","0","1110","42188",80
"14041","40","40","20","0","0","0","100","31250",0
"14042","670","490","290","160","120","0","1730","34949",180
"14043","4600","3670","2230","1380","1250","110","13240","38760",590
"14047","1070","740","530","380","430","60","3210","43074",180
"14048","3080","1650","800","490","440","40","6500","27576",400
"14051","2900","1390","1040","1080","2550","1270","10230","69832",270
"14052","2830","1670","1210","970","1840","570","9090","50930",310
"14054","220","170","110","80","70","0","650","40441",40
"14055","230","170","110","90","100","0","700","42647",40
"14057","1340","860","580","480","700","120","4080","45349",230
"14058","330","270","190","130","130","0","1050","43056",50
"14059","1520","970","710","600","980","260","5040","51056",200
"14060","70","50","40","20","0","0","180","35000",0
"14062","590","410","240","160","160","0","1560","36585",90
"14063","1830","1090","750","560","730","100","5060","41055",240
"14065","300","200","140","90","40","0","770","35625",90
"14066","180","130","80","50","30","0","470","35577",30
"14067","840","600","410","260","300","20","2430","40625",180
"14068","1090","550","450","380","800","290","3560","57778",90
"14069","110","100","60","60","90","0","420","50000",30
"14070","910","640","370","210","190","0","2320","34766",160
"14072","3200","2030","1430","1260","2200","550","10670","51836",360
"14075","7370","4830","3270","2640","3670","700","22480","45031",940
"14080","610","490","310","270","330","40","2050","46173",130
"14081","520","340","200","90","110","0","1260","33088",90
"14082","60","70","60","30","30","0","250","48214",0
"14085","1080","670","540","550","890","130","3860","58333",170
"14086","5420","3450","2470","1990","3640","610","17580","49420",680
"14091","220","160","110","60","50","0","600","37500",60
"14092","1800","1170","870","680","980","240","5740","47863",260
"14094","9320","6160","3580","2430","2900","420","24810","37520",1480
"14098","500","380","220","140","130","0","1370","37171",100
"14101","330","200","130","80","60","0","800","33750",70
"14102","220","120","90","80","140","0","650","46875",30
"14103","2040","1330","740","420","380","40","4950","33177",290
"14105","810","530","340","240","180","30","2130","37028",130
"14108","1000","750","460","280","310","20","2820","38667",220
"14111","530","380","280","170","190","20","1570","41776",110
"14113","130","110","70","50","40","0","400","40909",40
"14120","7920","5620","3280","2370","3140","430","22760","40391",1100
"14125","610","440","280","180","200","0","1710","38920",110
"14127","4560","2830","2070","1610","3180","1440","15690","55495",520
"14129","190","180","100","70","60","0","600","40278",40
"14131","940","610","400","280","340","40","2610","39959",230
"14132","990","740","480","310","390","40","2950","41385",170
"14134","60","40","20","30","0","0","150","34375",0
"14136","920","570","350","220","200","20","2280","34649",140
"14138","330","230","140","70","60","0","830","34239",50
"14139","360","230","180","150","200","40","1160","48913",60
"14141","1350","950","590","350","430","60","3730","38553",190
"14143","200","170","110","90","80","0","650","43382",40
"14145","230","200","130","110","100","0","770","44375",50
"14150","7800","6010","3720","2390","2040","140","22100","38519",1000
"14167","250","210","150","90","90","0","790","42262",60
"14170","350","260","220","180","190","50","1250","51705",50
"14171","370","260","160","110","90","0","990","37019",80
"14172","540","350","250","190","220","30","1580","42857",120
"14174","940","590","400","320","520","110","2880","46186",120
"14201","2550","1270","470","210","220","60","4780","23431",210
"14202","680","420","170","110","190","180","1750","36607",50
"14203","340","200","110","70","80","30","830","34375",0
"14204","2080","760","290","140","120","0","3390","20373",140
"14206","4590","2850","1140","570","330","0","9480","26316",500
"14207","5840","2690","740","330","170","0","9770","20912",510
"14208","2320","930","330","120","70","0","3770","20312",160
"14209","1420","970","470","210","300","180","3550","34149",120
"14210","3250","1800","710","340","190","0","6290","24192",400
"14211","5620","2140","580","220","120","0","8680","19306",390
"14212","2530","1130","330","170","90","0","4250","20998",260
"14213","5670","2400","680","300","220","40","9310","20525",380
"14214","3460","1870","860","520","770","230","7710","30281",220
"14215","9400","4640","1630","720","510","30","16930","22513",700
"14216","3940","3360","1720","940","1080","320","11360","37946",440
"14217","4090","3200","1870","1250","1210","150","11770","39023",480
"14218","4160","2550","1170","610","450","30","8970","28186",460
"14219","2310","1710","1020","600","490","30","6160","36257",350
"14220","4550","3410","1710","1040","960","60","11730","34641",590
"14221","7870","4600","3700","3230","5640","2200","27240","57770",640
"14222","1840","1710","870","490","780","450","6140","42982",190
"14223","4070","3150","2110","1440","1510","160","12440","42063",490
"14224","7070","5270","3430","2680","3060","300","21810","43193",940
"14225","6830","5360","2870","1630","1150","70","17910","34911",880
"14226","4720","3040","2220","1540","2210","830","14560","46053",430
"14227","4080","3330","2040","1280","1190","60","11980","39339",520
"14228","3350","2130","1310","940","1300","360","9390","40786",340
"14301","3070","1310","400","190","140","0","5110","20806",280
"14303","1460","670","210","90","60","0","2490","21318",170
"14304","5990","4090","2220","1380","1400","140","15220","34902",810
"14305","3730","1810","830","500","450","60","7380","24732",400
"14411","2220","1530","770","470","420","50","5460","33333",350
"14414","1170","860","500","350","510","70","3460","41279",160
"14416","630","490","310","240","260","0","1930","42092",100
"14418","210","150","80","50","70","0","560","36667",30
"14420","2880","1840","1160","860","1070","140","7950","39878",330
"14422","350","290","160","120","160","0","1080","41379",60
"14423","770","610","380","270","280","40","2350","41598",120
"14424","4810","3020","1940","1340","1880","560","13550","41267",470
"14425","2000","1410","910","700","900","110","6030","42996",250
"14427","330","240","160","110","90","0","930","39062",60
"14428","1390","1020","630","580","780","90","4490","45956",160
"14432","900","670","440","250","290","20","2570","39366",130
"14433","810","570","300","160","170","0","2010","33553",110
"14435","440","360","240","160","220","40","1460","45139",80
"14437","1720","1130","730","380","390","40","4390","35509",260
"14441","60","50","20","30","0","0","160","35000",0
"14445","1580","1230","650","300","270","50","4080","34350",170
"14450","6180","3790","2860","2420","4770","1480","21500","56818",530
"14454","1010","600","460","310","550","110","3040","46250",110
"14456","3780","2260","1090","720","860","160","8870","32246",420
"14462","90","70","50","40","50","0","300","46429",0
"14464","1230","900","530","360","370","40","3430","38472",160
"14466","320","190","130","100","130","0","870","40132",40
"14467","1660","1180","780","480","660","90","4850","41208",150
"14468","2900","2140","1430","1180","1470","230","9350","45736",310
"14469","1010","700","460","320","390","70","2950","41607",140
"14470","1300","1050","580","380","320","40","3670","37738",210
"14471","500","350","190","150","160","30","1380","38571",70
"14472","1250","690","510","430","920","470","4270","59559",120
"14475","70","20","20","20","50","0","180","50000",0
"14476","350","270","170","120","130","0","1040","40741",50
"14477","310","190","120","70","100","0","790","36184",50
"14478","150","100","80","50","80","0","460","45000",0
"14480","190","110","70","40","50","0","460","34091",30
"14481","310","220","160","90","110","0","890","40341",60
"14482","1470","1020","610","440","450","70","4060","38725",170
"14485","730","470","290","230","270","30","2020","39894",80
"14486","40","50","30","0","30","0","150","42500",0
"14487","980","590","490","320","480","80","2940","45763",140
"14489","1290","930","470","290","260","0","3240","33871",140
"14502","1710","1140","770","590","920","120","5250","45066",210
"14504","340","280","140","80","50","0","890","34375",50
"14505","880","670","430","290","290","20","2580","40299",130
"14506","160","100","70","70","180","80","660","75000",0
"14507","250","170","110","60","60","0","650","36029",30
"14510","960","540","330","210","170","0","2210","31713",200
"14512","880","540","360","220","220","50","2270","36806",120
"14513","2770","1700","980","540","490","40","6520","32206",310
"14514","920","690","450","330","500","60","2950","45109",120
"14516","370","290","180","100","110","0","1050","38362",70
"14517","500","310","200","130","140","0","1280","36290",90
"14519","1900","1380","920","700","1000","150","6050","45380",260
"14521","500","350","190","100","120","0","1260","34286",60
"14522","1650","1190","710","430","440","70","4490","37500",230
"14525","420","350","230","170","150","0","1320","42143",70
"14526","3070","1850","1490","1160","2370","770","10710","57299",290
"14527","2340","1500","860","530","510","120","5860","34833",250
"14530","920","710","430","230","200","30","2520","36972",180
"14532","750","600","330","240","230","30","2180","39167",80
"14533","260","220","130","80","90","0","780","39773",50
"14534","4110","1880","1690","1640","3950","2870","16140","80945",260
"14536","110","70","60","20","30","0","290","37500",30
"14541","350","290","160","100","110","20","1030","39224",50
"14543","500","370","270","220","320","80","1760","50926",50
"14544","350","230","150","80","90","20","920","36957",30
"14546","800","650","400","280","310","60","2500","42308",90
"14548","720","520","300","190","210","0","1940","37019",80
"14550","260","210","140","80","60","0","750","38690",60
"14551","1030","710","340","210","180","30","2500","32746",140
"14555","150","110","70","40","70","20","460","43182",30
"14559","2860","1990","1350","1070","1580","310","9160","46608",310
"14560","330","260","160","100","140","0","990","40865",70
"14561","500","360","230","150","130","0","1370","37847",60
"14564","2300","1300","870","680","1640","900","7690","57040",200
"14568","900","680","490","420","510","60","3060","48162",120
"14569","1100","740","470","280","290","40","2920","37162",160
"14571","240","160","90","60","60","0","610","35156",40
"14572","810","640","380","220","190","0","2240","37109",140
"14580","8250","5060","3850","3170","5310","1420","27060","51429",710
"14585","60","40","20","20","0","0","140","31250",0
"14586","1480","1130","870","710","960","80","5230","50144",160
"14589","1390","830","590","380","440","70","3700","38855",190
"14590","940","610","360","210","170","30","2320","34016",160
"14591","250","190","160","80","90","0","770","42763",40
"14604","330","260","110","60","80","40","880","35577",20
"14605","2950","940","140","50","50","0","4130","17500",200
"14606","6030","3810","1790","920","670","50","13270","28970",630
"14607","3140","2950","1240","430","480","190","8430","34110",280
"14608","2950","1210","360","130","120","30","4800","20339",200
"14609","9020","5910","2730","1360","1090","90","20200","29569",900
"14610","2060","1760","1200","750","1200","670","7640","50000",150
"14611","4290","1680","440","150","90","0","6650","19376",280
"14612","6070","4480","2670","1930","2410","390","17950","41211",680
"14613","3470","1520","440","170","130","0","5730","20641",280
"14614","70","50","50","0","30","20","220","45000",0
"14615","3530","2580","1040","500","370","20","8040","29748",320
"14616","5710","4520","2380","1200","980","100","14890","34596",660
"14617","4020","2760","1990","1450","1930","260","12410","44792",420
"14618","2730","1670","1470","1100","2270","1270","10510","64541",190
"14619","3180","2030","740","300","250","0","6500","25862",270
"14620","3920","3450","1660","820","920","220","10990","36413",320
"14621","7830","3300","840","270","160","20","12420","19828",560
"14622","2300","1800","1180","680","610","90","6660","39306",250
"14623","3690","2660","1670","880","720","50","9670","35761",290
"14624","6230","4930","3380","2220","2530","260","19550","42977",660
"14625","1650","1040","830","610","1130","330","5590","53163",150
"14626","5490","3940","2420","1710","2050","340","15950","40768",510
"14701","8030","4000","2100","1170","1110","180","16590","26656",730
"14706","1050","570","390","270","360","110","2750","39254",130
"14709","280","160","110","60","60","0","670","33594",40
"14710","620","380","270","150","160","20","1600","36842",80
"14711","260","200","130","70","50","0","710","36875",50
"14712","580","300","220","130","240","80","1550","41250",60
"14714","70","40","30","30","0","0","170","34375",0
"14715","540","270","150","120","70","0","1150","28241",70
"14716","400","270","130","60","70","0","930","31019",70
"14717","120","80","40","50","0","0","290","32812",0
"14718","330","220","160","90","90","0","890","38068",60
"14719","550","410","240","120","120","0","1440","35366",110
"14723","230","150","80","60","40","0","560","33333",60
"14724","420","250","160","110","80","0","1020","34000",50
"14726","190","130","50","20","20","0","410","27885",0
"14727","910","540","320","230","220","30","2250","34954",130
"14728","180","110","60","60","40","0","450","35227",0
"14729","150","110","90","30","30","0","410","37500",30
"14731","250","170","110","80","110","30","750","43382",40
"14733","810","510","260","140","110","0","1830","30147",110
"14735","420","260","160","90","80","0","1010","33173",80
"14736","90","60","30","30","30","0","240","37500",0
"14737","720","450","250","160","130","0","1710","32500",160
"14738","640","420","270","170","160","0","1660","36310",80
"14739","550","300","150","80","70","0","1150","27083",90
"14740","220","130","100","60","40","0","550","35577",40
"14741","370","220","110","80","100","0","880","32955",60
"14743","340","190","130","80","70","0","810","33553",40
"14744","190","110","80","50","50","0","480","36364",0
"14747","390","290","170","80","70","0","1000","34483",60
"14748","150","80","30","30","20","0","310","26562",30
"14750","780","490","340","230","310","120","2270","43112",80
"14753","230","120","70","40","40","0","500","29167",40
"14754","110","70","50","50","0","0","280","35714",0
"14755","490","330","180","100","100","0","1200","33333",80
"14757","630","340","220","150","140","20","1500","33824",80
"14760","3690","1960","1160","690","670","160","8330","31059",400
"14767","320","190","100","60","70","0","740","31579",30
"14769","170","120","50","30","30","0","400","31250",30
"14770","520","320","210","130","120","0","1300","35156",90
"14772","670","470","250","150","150","0","1690","34309",120
"14775","450","320","200","90","60","0","1120","33594",90
"14777","110","70","40","30","30","0","280","35714",20
"14779","1450","850","360","180","130","30","3000","26471",250
"14781","390","230","130","70","80","0","900","31522",50
"14782","390","250","160","80","60","0","940","33000",80
"14784","180","120","60","40","20","0","420","31250",30
"14787","940","540","330","240","190","30","2270","34028",110
"14801","890","550","370","200","190","0","2200","34545",190
"14802","170","80","50","40","70","0","410","35938",0
"14803","220","120","80","60","70","0","550","36458",30
"14804","210","150","120","70","80","0","630","42500",40
"14805","180","130","80","50","70","0","510","39423",30
"14806","380","220","160","100","100","0","960","36364",90
"14807","470","370","220","150","150","0","1360","39189",80
"14808","120","90","30","30","0","0","270","29167",0
"14809","430","320","170","90","80","0","1090","33984",60
"14810","2210","1270","710","450","420","30","5090","31594",310
"14812","600","380","240","150","160","0","1530","35855",120
"14813","440","260","160","90","100","0","1050","33173",90
"14814","290","180","170","120","200","50","1010","55147",40
"14815","160","100","60","50","50","0","420","37500",30
"14816","130","80","60","30","40","0","340","37500",0
"14817","450","360","200","130","180","0","1320","39583",50
"14818","320","230","140","100","90","20","900","39130",40
"14819","140","70","40","30","0","0","280","25000",20
"14820","100","60","50","50","0","0","260","37500",30
"14821","570","400","250","170","140","20","1550","37812",90
"14822","190","150","80","40","30","0","490","34167",40
"14823","660","410","270","150","140","0","1630","34451",150
"14824","120","80","60","40","30","0","330","39062",0
"14825","150","110","60","40","30","0","390","35227",0
"14826","320","250","150","90","90","0","900","38000",70
"14830","3500","2150","1490","870","1170","420","9600","40116",450
"14836","140","120","90","60","50","0","460","43750",40
"14837","910","570","300","170","160","30","2140","32018",110
"14838","330","210","160","90","110","0","900","39286",70
"14839","120","90","40","30","20","0","300","33333",20
"14840","510","360","210","170","210","60","1520","42361",70
"14841","190","120","50","40","70","0","470","34375",0
"14842","130","80","70","40","50","0","370","42188",0
"14843","2460","1440","830","450","430","50","5660","31424",350
"14845","3450","2160","1560","1100","1460","420","10150","43808",420
"14846","120","90","40","60","0","0","310","34722",30
"14847","420","310","170","110","110","0","1120","36290",40
"14850","7500","5530","2930","1890","3440","1600","22890","42835",420
"14853","80","50","0","30","0","0","160","25000",0
"14855","150","100","50","30","20","0","350","31250",0
"14858","260","150","110","90","90","0","700","40000",50
"14859","170","140","70","60","40","0","480","37500",50
"14860","200","120","80","50","60","0","510","36458",30
"14861","220","170","110","60","60","0","620","38235",40
"14864","220","140","70","50","50","0","530","33036",40
"14865","470","290","190","110","110","20","1190","35776",80
"14867","1080","750","410","250","250","30","2770","35167",110
"14869","230","160","90","70","50","0","600","35938",30
"14870","1520","850","700","490","720","330","4610","48088",210
"14871","660","440","380","260","330","60","2130","48011",80
"14872","110","80","30","40","0","0","260","31250",0
"14873","400","290","150","90","90","0","1020","34483",80
"14874","50","50","0","0","20","0","120","30000",0
"14877","80","50","50","0","20","0","200","35000",0
"14878","130","80","40","30","30","0","310","32812",20
"14879","400","240","170","90","80","0","980","34375",70
"14880","260","170","110","80","50","0","670","36029",50
"14881","50","70","0","30","0","0","150","33929",0
"14882","610","470","320","210","290","90","1990","45479",60
"14883","690","510","290","190","170","20","1870","37010",90
"14884","70","40","30","30","0","0","170","34375",0
"14885","130","90","60","40","0","0","320","33333",30
"14886","1100","770","500","340","490","110","3310","43019",80
"14889","290","170","100","70","50","0","680","32353",40
"14891","820","490","310","190","190","30","2030","34949",130
"14892","1590","910","470","330","290","40","3630","31181",260
"14894","270","140","100","70","60","0","640","33929",40
"14895","1740","980","610","350","350","60","4090","32781",240
"14897","130","90","60","40","40","0","360","38889",40
"14898","260","140","90","50","50","0","590","31250",40
"14901","2870","1310","630","320","270","40","5440","23693",260
"14903","1360","890","550","330","370","170","3670","38343",160
"14904","3370","1880","980","460","320","20","7030","26928",350
"14905","1480","900","670","450","630","200","4330","44028",140
