"ZIP","0_25000","25000_50000","50000_75000","75000_100000","100000_200000","200000_","nbrReturns","medianInc","jl_benef"
10001,"3740","2500","1950","1410","2580","2340","14520","63077",420
10002,"21180","8210","4810","2710","3620","1650","42180","24894",920
10003,"5030","3870","3960","3220","6300","6280","28660","86413",640
10004,"360","250","290","210","520","850","2480","125000",60
10005,"690","750","860","660","1360","1620","5940","100735",100
10006,"310","290","330","250","620","570","2370","100806",50
10007,"470","320","280","210","590","1570","3440","174576",60
10009,"9560","6660","5480","3580","5030","2100","32410","49944",870
10010,"2560","2280","2550","1980","4010","3980","17360","91288",370
10011,"5120","3680","3650","3130","6870","7470","29920","95048",750
10012,"2390","1740","1730","1340","2730","2540","12470","81996",260
10013,"4260","2060","1630","1160","2030","3800","14940","67638",230
10014,"2770","2160","2330","2040","4640","4720","18660","100647",440
10016,"5170","4650","5170","3820","6930","6200","31940","81414",640
10017,"1820","1380","1490","1250","2650","3260","11850","99700",230
10018,"1430","1020","820","580","1200","1340","6390","72713",140
10019,"4920","3650","3560","2540","5400","5040","25110","79183",680
10021,"3460","2600","3150","2520","4890","6910","23530","100716",420
10022,"2770","2130","2320","2010","4480","6130","19840","115402",340
10023,"5910","3920","3720","3290","7610","9620","34070","102562",890
10024,"5710","3590","3570","2860","6110","8570","30410","95411",770
10025,"12490","7810","6190","4190","7460","7470","45610","60117",1240
10026,"6900","4270","2550","1410","1880","1030","18040","37412",630
10027,"11490","6590","3430","1830","2430","1410","27180","32967",800
10028,"3920","2860","3730","2950","5300","6340","25100","92288",490
10029,"16590","9360","4620","1880","1780","830","35060","27511",1040
10030,"6490","3620","1810","810","700","200","13630","27244",430
10031,"13840","7940","4010","1660","1510","380","29340","27613",1050
10032,"14390","7810","3820","1520","1420","340","29300","25832",1050
10033,"12800","6580","3400","1580","1940","630","26930","27527",1070
10034,"9300","4880","2830","1390","1430","310","20140","28945",770
10035,"7040","3890","1950","910","1020","320","15130","28374",500
10036,"4480","3160","2580","1920","3800","2780","18720","66667",730
10037,"3870","2750","1850","1000","920","140","10530","37682",350
10038,"3440","1930","1590","1120","2190","1820","12090","60613",280
10039,"6250","3600","1810","770","690","170","13290","27743",480
10040,"9790","5360","2970","1390","1410","380","21300","29011",870
10044,"1150","740","640","440","820","470","4260","59375",100
10065,"2350","2050","2070","1610","3240","4460","15780","97050",290
10069,"370","260","240","190","580","1250","2890","166379",50
10075,"2160","1600","1960","1560","3110","3690","14080","96154",260
10128,"5890","4300","4920","3600","6500","7740","32950","84479",720
10162,"100","50","60","60","190","290","750","155263",0
10280,"480","360","460","400","1140","1360","4200","135088",80
10282,"220","140","130","130","360","1330","2310",NA,40
10301,"6490","3910","2720","1680","2430","850","18080","41304",450
10302,"3220","1860","1160","730","960","150","8080","36022",210
10303,"5280","2940","1700","1020","1140","90","12170","31845",310
10304,"8240","4420","2400","1520","2250","890","19720","34163",500
10305,"6700","4150","2840","2040","2980","590","19300","42771",590
10306,"8250","5130","4030","3000","5120","1310","26840","50248",820
10307,"1790","1090","850","710","1470","590","6500","60882",190
10308,"3780","2400","1970","1700","3060","710","13620","57995",390
10309,"4100","2550","2080","1690","3470","1110","15000","60216",520
10310,"4370","2330","1490","1070","1760","440","11460","39592",290
10312,"7860","5230","4240","3480","6650","1770","29230","58992",920
10314,"12330","8150","6040","4590","7790","1840","40740","49663",1160
10451,"12230","6570","2730","1020","690","50","23290","23804",790
10452,"21350","9730","3590","960","550","20","36200","21194",1230
10453,"23280","9690","3160","900","540","30","37600","20189",1270
10454,"9740","4170","1320","350","240","20","15840","20329",510
10455,"10300","4900","1780","500","300","0","17780","21578",660
10456,"24520","10970","3410","960","530","0","40390","20590",1390
10457,"20000","8480","2830","900","470","40","32720","20450",1010
10458,"19820","9110","3470","1120","760","40","34320","21645",1060
10459,"12280","5930","1990","660","420","0","21280","21661",800
10460,"14600","6900","2300","800","490","30","25120","21507",890
10461,"8580","6210","4160","2280","2530","330","24090","38949",710
10462,"16080","10910","6950","3110","2300","160","39510","33421",1130
10463,"12390","7620","5120","3080","4290","1440","33940","40026",1020
10464,"560","400","360","270","420","160","2170","58681",70
10465,"6210","4410","3330","2180","3050","520","19700","45635",670
10466,"14740","9390","4410","2150","1930","120","32740","29340",910
10467,"22140","12740","5830","2200","1630","100","44640","25353",1290
10468,"20220","9370","3790","1350","870","60","35660","22045",1130
10469,"13400","8810","4920","2570","2670","300","32670","33329",880
10470,"2840","1940","1230","670","840","140","7660","37758",220
10471,"2360","1650","1640","1230","2100","1090","10070","65625",230
10472,"16190","7800","3010","1110","720","50","28880","22298",920
10473,"12730","7720","3940","1830","1570","120","27910","28967",1080
10474,"2940","1410","490","140","70","0","5050","21471",160
10475,"7390","6500","4680","2430","1700","90","22790","40404",500
10504,"960","380","320","260","720","2070","4710","160417",70
10516,"690","430","340","290","650","340","2740","68382",70
10528,"1540","910","760","540","990","1160","5900","66447",120
10550,"8570","5550","2600","1200","1070","70","19060","29324",630
10583,"4010","1710","1570","1260","3280","6900","18730","124848",320
10598,"3580","1960","1680","1320","3850","2170","14560","76136",380
10601,"1750","1200","840","570","990","700","6050","52232",120
10603,"2810","2010","1580","1070","1770","730","9970","52611",280
10606,"3030","1920","1030","620","1030","650","8280","39453",190
10704,"4840","3830","3060","1940","2780","530","16980","48825",500
10705,"8050","4760","2470","1280","1540","410","18510","31329",640
10707,"1280","750","690","520","1150","810","5200","70652",120
10708,"2340","1430","1540","1210","2370","2430","11320","82231",250
10801,"6860","4030","2550","1630","2430","960","18460","39702",800
10803,"1330","770","610","480","1010","1800","6000","90104",120
11001,"3850","2380","1800","1460","3090","1290","13870","59792",310
11003,"8250","6240","3690","2410","2980","410","23980","39984",630
11004,"2010","1330","1080","860","1330","230","6840","51852",140
11005,"210","150","200","200","440","250","1450","95625",0
11030,"1880","770","740","560","1370","3270","8590","125182",120
11040,"5530","3430","2760","2180","5140","2280","21320","65399",320
11101,"5730","3590","2740","1810","3120","1540","18530","49617",570
11102,"6820","4500","3360","1900","2200","470","19250","40583",570
11103,"7090","5080","4060","2040","2170","390","20830","41363",670
11104,"5230","3460","2610","1570","1830","410","15110","41799",480
11105,"6400","4530","3610","2030","2460","640","19670","43957",670
11106,"7650","5090","3930","2200","2510","500","21880","41159",680
11109,"360","300","400","410","1110","980","3560","127928",70
11201,"5900","4120","4310","3590","7100","6950","31970","86525",880
11203,"16110","11100","5520","2690","2140","200","37760","31239",1050
11204,"16610","7590","3720","2020","2430","830","33200","24985",770
11205,"7000","4250","2700","1600","2200","1020","18770","39029",560
11206,"17360","10000","4930","2140","1730","330","36490","27212",1140
11207,"22470","12270","5000","2160","1510","120","43530","24216",1390
11208,"23690","12310","4820","1820","1280","90","44010","23222",1300
11209,"10950","6560","5560","3820","5280","1940","34110","48266",900
11210,"11580","7590","4230","2230","2650","1190","29470","35392",840
11211,"10060","6720","4980","3080","4190","1920","30950","45145",900
11212,"20670","10750","4260","1620","1030","40","38370","23204",1190
11213,"13450","8470","4010","1680","1380","310","29300","28542",900
11214,"19700","9560","4930","2910","3130","630","40860","26909",1060
11215,"6320","5390","5230","3710","6830","5450","32930","72729",1030
11216,"10410","8190","5200","2310","2260","650","29020","37515",960
11217,"4290","3430","3060","2120","3630","2700","19230","65482",660
11218,"13360","7370","4420","2720","3870","1380","33120","35855",790
11219,"20390","7160","2670","1410","1610","670","33910","20788",500
11220,"36120","10250","3660","1670","1810","390","53900","18653",750
11221,"17480","11820","5640","2290","1900","390","39520","29822",1220
11222,"5900","4960","4450","2670","3440","1150","22570","52388",890
11223,"15510","7450","3740","2220","2660","1160","32740","27886",840
11224,"10120","4890","2350","1280","1350","250","20240","25000",630
11225,"11770","8800","5070","2360","2070","530","30600","35028",980
11226,"23360","15390","7230","3080","2500","510","52070","29345",1610
11228,"8260","4010","2430","1690","2450","870","19710","34944",460
11229,"14850","7940","4770","3110","4320","1360","36350","35469",860
11230,"15200","8330","4500","2540","3340","1580","35490","32638",810
11231,"4320","2880","2300","1580","3250","2690","17020","64239",570
11232,"6290","3130","1670","780","790","200","12860","26118",290
11233,"14410","9310","4410","1920","1620","310","31980","29243",1020
11234,"14380","9770","6460","4360","6000","1590","42560","42656",1140
11235,"16790","8410","4900","3090","4160","1350","38700","32610",930
11236,"19250","13560","7240","3900","3610","360","47920","33684",1430
11237,"10550","7390","3350","1250","1030","160","23730","29449",700
11238,"7750","6650","5750","3350","4920","2520","30940","54652",940
11239,"2880","2210","1320","490","310","0","7210","33201",210
11354,"17930","5670","2820","1680","1870","450","30420","21207",470
11355,"34950","8470","3520","1800","1850","370","50960","18226",610
11356,"5860","2920","1470","900","1040","190","12380","27825",300
11357,"6160","3560","2890","2150","3730","1360","19850","51773",480
11358,"8030","3830","2320","1540","2510","750","18980","34530",340
11360,"2690","1630","1400","1210","2230","880","10040","62500",200
11361,"4950","2770","1930","1380","2200","700","13930","43186",310
11362,"2500","1580","1220","1060","1760","620","8740","55943",180
11363,"970","560","460","350","630","460","3430","60054",70
11364,"6060","3430","2580","1930","2950","850","17800","45700",320
11365,"8690","4620","2850","1930","2770","610","21470","36066",540
11366,"2460","1320","870","590","1080","410","6730","42140",110
11367,"7950","4100","2570","1570","2050","620","18860","34024",410
11368,"27870","12450","4960","1860","1300","90","48530","21766",960
11369,"8830","4610","2320","1070","1010","110","17950","25786",470
11370,"5980","3060","1810","990","1190","200","13230","30188",340
11372,"15910","8280","4810","2470","2880","670","35020","29831",860
11373,"27380","12280","5910","2610","2360","330","50870","23224",950
11374,"7960","4840","3760","2470","3130","740","22900","43027",550
11375,"9000","5930","5610","4350","7320","3260","35470","62500",900
11377,"20980","11150","6270","3220","3350","520","45490","28957",1020
11378,"6730","4020","2570","1710","2170","440","17640","37998",490
11379,"5550","3590","2860","1950","3070","730","17750","48155",510
11385,"19640","12760","7620","3880","4320","570","48790","34316",1510
11411,"3620","2850","1810","1140","1210","130","10760","40439",250
11412,"7580","5500","2970","1640","1480","110","19280","34364",490
11413,"7920","5760","3580","2060","2170","220","21710","37739",540
11414,"3780","2760","2280","1630","2350","520","13320","51316",420
11415,"2940","2040","1790","1130","1440","330","9670","48223",250
11416,"6080","3390","1580","680","560","40","12330","25627",390
11417,"6370","3910","2120","1160","1250","150","14960","32097",500
11418,"8150","4520","2340","1180","1290","230","17710","28899",470
11419,"11940","6370","2820","1280","1050","100","23560","24665",500
11420,"10010","6320","3240","1690","1610","150","23020","30934",570
11421,"9220","5310","2820","1390","1430","140","20310","29402",610
11422,"5930","4510","2690","1590","1660","180","16560","38027",410
11423,"6370","4180","2090","1150","1200","290","15280","32596",320
11426,"3050","1870","1360","980","1570","300","9130","45254",180
11427,"4110","2780","1780","1200","1460","360","11690","40603",250
11428,"3940","2640","1530","910","1010","90","10120","35606",240
11429,"5330","3810","1960","1070","1060","70","13300","33661",330
11430,"60","40","50","30","0","0","180","43750",0
11432,"13450","6880","3460","1800","2100","630","28320","27580",540
11433,"8020","4600","2090","960","810","60","16540","26359",440
11434,"12710","9480","5410","2660","2160","160","32580","34441",820
11435,"11830","6780","3760","1990","1830","180","26370","29996",640
11436,"4170","2770","1480","710","570","30","9730","31273",240
11548,"220","110","90","50","130","100","700","55556",0
11553,"6060","4250","1990","1070","1050","90","14510","32029",460
11557,"1040","560","480","350","840","850","4120","73958",60
11559,"1200","560","440","290","510","860","3860","59659",50
11561,"4950","3360","2900","2370","4050","1810","19440","62155",500
11563,"3030","2020","1700","1360","2680","840","11630","61250",300
11565,"1080","650","600","530","1340","590","4790","78066",90
11576,"1410","620","490","390","1120","2190","6220","117857",80
11580,"6720","4670","3460","2550","3970","730","22100","48180",530
11590,"9150","5720","3240","2130","3760","1340","25340","40385",750
11598,"1450","660","580","470","1210","1480","5850","87500",90
11691,"11040","6020","2750","1260","1250","290","22610","26100",590
11692,"4120","2350","1120","570","540","80","8780","27872",280
11693,"2290","1320","880","550","650","90","5780","36364",230
11694,"2680","1630","1240","900","1720","710","8880","52621",240
11697,"520","310","280","270","590","240","2210","74554",40
11709,"990","530","440","370","800","410","3540","64205",100
11710,"4670","2820","2250","1890","4380","1930","17940","66444",400
11727,"4270","3490","2320","1650","2640","350","14720","47135",580
11735,"5070","3330","2700","1950","3580","1060","17690","54120",470
11757,"7370","5180","3580","2500","4240","670","23540","46236",910
11797,"1160","520","450","330","790","1360","4610","88258",70
14202,"650","440","190","120","170","180","1750","37784",60
14221,"7720","4570","3790","3300","5760","2230","27370","59202",650
14226,"4690","3200","2150","1510","2260","840","14650","45586",360
